# Menu
User = Пользователь
Join... = Присоединиться...
Login... = Войти...
Log in = Войти
Logout = Выйти
Change password... = Изменить пароль...
User Preference = Настройки пользователя
System Settings... = Системные настройки...
System Settings = Системные настройки
Crash = Восстановить
Invite friends... = Пригласить друзей...
Language = Язык
Language Setting = Выбор языка

Document Recovery = Восстановить файл
Your Preferences Information = Информация о ваших предпочтиниях
File = Файл
New = Новый
Project... = Проект...
Schematic = Схема
Schematic-Simulation = Симулятор схем
Spice Symbol = Символ Spice
Spice Subckt = Подсхема Spice
spicePre =
PCB = Печатная плата
Schematic Module = Модуль компонентов
PCB Module = Модуль корпусов
Save... = Сохранить...
Save As... = Сохранить Как...
Save As Module... = Сохранить Как Модуль...
Print = Печать
Export Document = Экспорт документа
LTspice... = LTspice...
Eagle... = Eagle...
Altium... = Altium...
Cadence... = Cadence...
Pads... = Pads...
DXF = DXF
Import = Импорт


Edit = Правка
Undo = Отменить
Redo = Повторить
Cut = Вырезать
Copy = Копировать
Paste = Вставить
Select = Выбрать
Delete = Удалить
Clear All = Удалить всё
Move = Переместить
Drag = Тащить
Bring to Front = На передний план
Send to Back = На задний план
Align = Выровнять
Align Left = Выровнять по левому краю
Align Right = Выровнять по правому краю
Align Top = Выровнять по верхнему краю
Align Bottom = Выровнять по нижнему краю
Align Horizontal Centers = Выровнять центры по горизонтали
Align Vertical Centers = Выровнять центры по вертикали
Distribute Horizontally = Распределить по горизонтали
Distribute Vertically = Распределить по вертикали
Distribute Left Edges Equidistantly = Распределить равномерно левого края
Distribute Top Edges Equidistantly = Распределить равномерно верхнего края
Align Grid = Выровнять по сетке
Rotate = Повернуть
Rotate Left = Повернуть влево
Rotate Right = Повернуть вправо
Flip Horizontal = Отразить по горизонтали
Flip Vertical = Отразить по вертикали
Rotate and Flip = Повернуть и отразить
Group/Ungroup Symbol... = Группировать/Разгруппировать символ

[menu_project]
View = Вид
[/menu_project]
Find = Найти
Zoom In = Увеличить
Zoom Out = Уменьшить
Fit in Window = В размер окна
Refresh = Обновить
Snap = Шаг
Cross Cursor = Курсорные линии
Toolbars = Панели инструментов
Drawing Tools = Рисование
Wiring Tools = Соединения
Power Objects = Источники питания
PCB Tools = Печатная плата
Footprint Tools = Посадочное место
Layers Tool = Слои
Layer Manager = Редактор слоёв
Enable and Show All Layers = Включить и показать все слои
Net Visible = Отображение Цепи
Auto = Авто
Digital Objects = Цифровые объекты
Tools = Инструменты
Arc Center = Центр дуги
Arc Type = Тип дуги
Center Point Arc = По центру дуги
Two-point Arc = Дуга по двум точкам

Place = Установка
Drawing Tools = Рисование
Arc = Дуга
Elliptical Arc = Эллиптическая дуга
Ellipse = Эллипс
Circle = Круг
Pie = Сегмент
Line = Линия
Polyline = Полилиния
Rectangle = Прямоугольник
Rectangular = Прямоугольный
The rectangle does not support non-90 degree rotation. Please use Solid Region instead. = Прямоугольник не поддерживает поворот не кратный 90-градусам. Пожалуйста, используйте сплошную область.

Rect = Прямоугольник
Round Rectangle = Скругленный прямоугольник
Polygon = Многоугольник
Bezier = Безье
Path = Контур
Graphic = Изображение
Bus = Шина
Bus Entry = Ответвление шины
Junction = Соединение
Net Port = Порт Цепи
Voltage Probe = Тестер напряжения
Power Port = Порт питания
Wire = Провод
Annotation = Аннотация
Track = Дорожка
Image = Изображение
Arrow Head = Стреловой наконечник
Arrowhead = Стрелка
Arrow = Стрелка
No Connect Flag = Флаг "Не подключено"
Place = Установить
Pin = Контакт
Lock Selected Objects = Заблокировать выбранные объекты

Miscellaneous = Разное
Find Component = Найти компонент
Component = Компонент
Footprint... = Посадочное место...
This component is deleted! = Этот компонент удалён!
Convert = Конвертировать
Convert Schematic to PCB = Преобразовать схему в печатную плату
The component ID will be reset according to the component prefix, this operation will clear Undo histories. Please notice: = ID компонента будет сброшен согласно префиксу, эта операция очистит историю последних действий. Пожалуйста, имейте ввиду:
Please make sure the component prefixes of the schematic and PCB are corresponding = Пожалуйста, убедитесь, что префиксы компонентов соответствуют для схемы и печатной платы
Please reset the component ID of corresponding schematic or corresponding PCB too = Пожалуйста, сбросьте ID компонента для соответствующей схемы или печатной платы
Do you want to continue? = Вы хотите продолжить?
Reset Component Unique ID = Сбросить уникальный ID компонента
Component ID reset successfully! = ID компонента успешно сброшен!
Convert to PCB = Конвертировать в печатную плату
Update PCB = Обновить печатную плату
Shortcut Keys Setting = Настройки горячих клавиш
Edit Symbol... = Изменить символ...
Highlight Net... = Подстветить Цепь...
Simulate = Симулировать
Simulation = Симуляция
Standard Mode = Стандартный
Simulation Mode = Симуляция
Change to Standard Mode = Стандартный
Change to Simulation Mode = Симуляция
Welcome to Use LCEDA = Добро прожаловать в LCEDA
Welcome to Use EasyEDA = Добро пожаловать в EasyEDA
Enable Education Edition Features for Free >>> = Разрешить свободное использование возможностей обучающей версии >>>
Quick Start = Быстрый cтарт
More Help = Больше информации
Explore = Обзор
Message = Сообщение
[start]
Example = Образец
Forum = Форум
Tutorials = Обучение
Videos = Видео
[/start]
Custom Data = Пользовательские данные
LCEDA = LCEDA

Copy Result Image = Копировать как изображение
Export Result Image = Экспортировать как изображение
Simulation Result = Результат Симуляции
Simulation Results... = Результаты Симуляции...
Simulate this Sheet = Симуляция листа
Simulate this Project = Симуляция проекта
Non-simulation mode, please switch to the simulation mode first and then run = Режим без симуляции, пожалуйста, сначала переключитесь в режим симуляции и запустите
Run the Document = Запустить документ
Run the Project... = Запустить проект...
Netlist for Document = Netlist для документа
Netlist for Project = Netlist для проекта
LTspice for This Sheet... = LTSpice для этого листа...
Spice for this Project... = Spice для этого проекта...
Protel/Altium for PCB... = Плата для Protel/Altium...
PADS for PCB... = Плата для PADS...
FreePCB for PCB... = Плата для FreePCB...
Eagle for PCB... = Плата для Eagle...
Kicad for PCB... = Плата для Kicad...
OrCAD for PCB... = Плата для OrCAD...
BOM report... = Отчёт BOM...
BOM for Document... = BOM для документа...
BOM for Project... = BOM для проекта...
Pin Manager... = Редактор контактов...
Spice Model... = SPICE-модель...
Layer Manager... = Управления Слоями...
Net Color... = Цвет Цепи...
Design Rule... = Правила проектирования...
Copper Area = Медная область
Rebuild Selected = Перестроить выбранное
Rebuild All = Перестроить все
Copper Area Manager... = Управление медными областями...
Export Pick and Place File = Экспортировать файл выбора и размещения
Measure Distance = Измерить расстояние
Set Canvas Origin by Mouse Location = Задать положение холста по положению мыши
Generates Pick and Place File = Генерировать файл выбора и размещения
Unroute All = Удалить трассировку
Auto Route = Автотрассировка
Export Autorouter File(DSN) = Экспортировать файл автотрассировки(DSN)
Import Autorouter Session File(SES) = Импортировать сессию автотрассировки(SES)
Autorouter File(DSN) = Файл с автортрассировкой(DSN)
Autorouter Session File(SES) = Файл с автотрассировкой сессии(SES)
Terminate Routing Automatically = Автоматически останавливать трассировку
Delete Segments = Удалить сегменты
Unroute Connections = Отменить трассировку соединений
Unroute Connection = Отменить трассировку соединения
Unroute Nets = Отменить трассировку Цепей
Select = Выбрать
Segments = Сегменты
Connection = Соединения
Net = Цепь
Apply Design Rule While Routing and Auto Placing Via = Применить правила проектирования при трассировке и автоматическом размещении переходных отверстий

Add SubPart = Добавить блок компонента
Annotate... = Замечание...
Config = Конфигурация

Help = Помощь
About = О приложении
Shortcut Keys = Горячие клавиши
FAQ = FAQ
Tutorials = Обучение
Basic Tutorials = Базовое обучение
Video Tutorials = Видеоуроки
Essential Check = Основная проверка
Simulation Tutorials = Инстукции по симуляции
Updated Instructions = Обновлённые инструкции
Open File Format = Открыть файл в формате
About Upgrade = Об обновлении
User Forum = Форум пользователей
Live Q/A = Живой вопрос/ответ
No live broadcast now = Сейчас нет прямых трансляций
Feature Request = Запрос функционала
Feature Requests = Запросы функционала
Bug Report = Отчёт об ошибке
Bug Reports = Отчёты об ошибках
Tips & Skill = Советы и обмен опытом
Ask for Help = Попросить помощи
Schematic Capture = Захват схемы
Spice Simulation = Симуляция Spice
Non-simulation mode = Режим без симуляции
PCB Layout = Макет печатной платы
General Discussion = Общие Обсуждения
More Information = Больше информации
Privacy Policy = Политика приватности
#Terms of Use & Privacy Policy
Terms of Service = Условия Использования
Plans and Pricing = Планы и цены
Help Translate = Помочь с переводом
About Us = О нас
Contact Us = Связаться с нами
Change History = История изменений
Join Us = Присоединиться
#PCB Fabrication Capabilities
PCB Fabrication = Подготовка плат к производству
Order Capabilities = Другие возможности
Order Price = Сумма заказа
Order Essential Check = Основная проверка заказа
Order FAQ = FAQ по заказам
Order Process = Процесс заказа
Full Screen = Полный экран

Support = Поддержка
[leftNavTabs]
Support = Поддержка
[/leftNavTabs]
Historical Records... = История записей...
Extensions = Расширения
Order PCB... = Заказать PCB...
Import Changes = Импортировать изменения
Press {0}F11{1} to switch to full screen. = Нажмите {0}F11{1} для переключения в полноэкранный режим.
Delete Selected = Удалить выбранное
Simulate... = Симулировать...
Config = Конфигурация
Terms of Service & Privacy Policy = Условия использования и политикаа конфиденциальности
Help Topics = Темы Помощи
3D Model(obj) = 3D Модель(obj)
3D Model(step) = 3D Модель(step)
SVG Source... = SVG Исходник...
File Source = Путь к файлу
Group These Items as a Symbol = Группировать элементы как символ
Group These Items as a Footprint = Группировать элементы как посадочное место
Set Canvas Origin = Установить начальные координаты холста
Document Setting = Настройки документа
Sheet Properties = Параметры листа
Set Board Outline = Установить границы платы
Teardrop... = Каплевидное Соединение...
Panelize... = Панелизация...
Check Dimension = Проверить размеры
Smart Dimension = Умное измерение
Footprint Wizard = Мастер посадочных мест
Footprint Wizard... = Мастер Посадочных мест...
Select package type = Выбрать тип корпуса
Smart Dimension Properties = Свойства умного измерения
Global Delete = Глобальное удаление
Cross Probe = Проверка курсорных линий
Cross Probe and Place = Проверка и установка курсорных линий
Paper Size = Размер Листа
Register = Зарегистрироваться
User Center = Центр пользователя

By Mouse Location = По координатам мыши
Set Coordinate = Установить координаты
By Coordinates... = По координатам...
By Center of Pads = По центру контакта
By Center Grid of Symbols = По центру сетки символов

#Schematic Canvas Properties
Properties = Свойства
Apply = Применить
Save as default = Сохранить по-умолчанию
Canvas Properties = Параметры окна редактора
Width = Ширина
Height = Высота
Background = Фон
Visible Grid = Отображать сетку
Grid Visible = Сетка включена
Real-Time Track Length = Длина дорожки в реальном времени
Display Real-Time Track Length = Отображать в реальном времени длину дорожки
Grid Color = Цвет сетки
Grid Size = Размер сетки
Grid Style = Стиль сетки
Grid.Line Width = Ширина линии сетки
Grid.Line Spacing = Шаг сетки
Copper to Board Outline = Отступ от медного слоя до границы платы
Improve Fabrication = Качественное производство
Spoke Width = Ширина контактной площадки
Stroke Color = Цвет линий
Stroke Width = Ширина линий
Stroke Style = Стиль линий
Fill Color = Цвет заливки
Selected Objects = Выбранные объекты
Frame Size = Размер рамки
Alt Snap = Шаг (при нажатии Alt)
Snap size when pressing the Alt key = Размер шага при нажатии клавиши Alt
Prefix Start = Префикс

#Text Properties
Text Properties = Параметры текста
Text = Текст
Color = Цвет
Font Family = Шрифт
Font Size = Размер шрифта
Font Weight = Толщина шрифта
Font Style = Стиль текста
Text Type = Тип текста
Text Anchor = Видимый текст
Baseline = Базовая линия
(Auto) = (Авто)
(auto) = (авто)
start = начало
middle = середина
end = конец
inherit = наследование
comment = комментарий
spice = spice
normal = нормальный
italic = курсив
Default = По-умолчанию
Add = Добавить
bold = жирный
bolder = жирнее
lighter = тоньще
Failed to parse the font file: {name} = Не удалось распознать файл шрифта: {name}
Please select a font file of ttf or woff format. = Пожалуйста, выберите файл шрифта в ttf или woff формате.
Add font success: {name} = Шрифт успешно добавлен: {name}
Failed to add font: {name} = Не удалось добавить шрифт: {name}
Add Font = Добавить шрифт
Failed to parse cached font: {name} = Не удалось распознать шрифт в кэше: {name}
Load cached fonts fail! = Ошибка при загрузке шрифтов из кэша!

#Stroke
Stroke Color = Цвет Линий
Stroke Width = Ширина Линий
Stroke Style = Стиль Линий
Fill Color = Цвет Заливки
X Radius = Радиус по X
Y Radius = Радиус по Y

#spice
Switch mode = Режим работы
The current documents will be closed, and reopen after switching mode, do you want to continue? = Текущий документ будет закрыт и автоматически открыт после переключения режима, продолжить?
PCB related documents are not allowed in emulation mode = Документы печатных плат не доступны в режиме эмуляции
Please change the editor to "Simulation" mode first at the top left corner. = Пожалуйста измените режим редактора на "Симуляция" в левом верхнем углу.
Please change the editor to "Standard" mode first at the top left corner. = Пожалуйста измените режим редактора на "Стандартный" в левом верхнем углу.
Common = Общие
spice.open = Открыть
spice.close = Закрыть
Sources = Источники питания
Instruments/Meters = Инструменты/Измерители
Transistors = Транзисторы
Digital Circuits = Цифровые схемы
Operational Amplifier = Операционный усилитель
multimeter = мультиметр
multimeter Settings = настройки мультиметра
FunctionGenerator Settings = Настройки функционального генератора
Voltage Source Settings = Настройки источника питания
Current Source Settings = Настройки источника тока
Powersw Settings = Настройки текущего источника
Resistor Settings = Настройки Резистора
Capacitor Settings = Настройки Конденсатора
Diode Settings = Настройки Диода
voltPowersw Settings = Настройки вольтажа переключателя
Inductor Settings = Настройки катушки индуктивности
VCVS Settings = Настройки VCVS
CCCS Settings = Настройки CCCS
VCCS Settings = Настройки VCCS
CCVS Settings = Настройки CCVS
JFET Settings = Настройки JFET
FET Settings = Настройки FET
Transmission Line Settings = Настройки линии передачи
Oscilloscope Settings = Настройки осциллографа
XFMR Settings = Настройки XFMR
LOGIC Settings = Настройки Логического Устройства
LOGICSTATE Settings = Настройки Логического Состояния
DIGITALCLOCK Settings = Настройки Цифровых Часов
Potentiometer Settings = Настройки Потенциометра
MUTUAL_INDUCTORS Settings = Настройки взаимной индуктивности
NE555 Settings = Настройка NE555
THREE_PHASE Settings = Настройка трехфазного источника
Logic_Probe Settings = Настройка Logic_Probe
78XX Settings = Настройка 78XX
79XX Settings = Настройка 79XX
OPAMP5PEE Settings = Настройка OPAMP5PEE
OPAMP5PEECN Settings = Настройка OPAMP5PEECN
OPAMP3PEE Settings = Настройка OPAMP3PEE
OPAMP3PEECN Settings = Настройка OPAMP3PEECN
DELAY_FUSE Settings = Настройка DELAY_FUSE
Ratio = Соотношение
K[%] = K[%]
Model = Модель
States = Состояние
Voltage[V] = Напряжение [В]
Voltage gain[V/V] = Усиление по напряжению [В/В]
Current gain[A/A] = Усиление по току [А/А]
Transconductance[Mho]
Transresistance[Ω]
Voltage Source Type = Тип Источника Питания
Current Source Type = Тип Источника Тока
multimeter type = тип мультиметра
power type = тип питания
Voltmeter Resistance(R)(Ω) = Внутреннее Сопротивление Мультиметра(R)(Ω)
Amperometer Resistance(R)(Ω) = Внутреннее Сопротивление Амперметра(R)(Ω)
mu.V = Вольтметр
mu.A = Амперметр
Sine Wave = Синусоидальный
Triangular Wave = Треугольный
Rectangular Wave = Прямоугольный
AC = Переменный Ток
DC = Постоянный Ток
SINE = Синусоидальный
PULSE = Импульс
EXP = Экспоненциальный
SFFM = Сигнал с синусоидальной частотной модуляцией (SFFM)
PWL = Вилка на плату (PWL)
B.spice = spice
DC Value[V] = Пост. напр.[В]
DC Value[A] = Пост. ток[А]
DC offset[V] = Пост. напр. смещ.[В]
DC offset[A] = Пост. ток смещ.[А]
Amplitude[V] = Амплитуда[В]
Amplitude[A] = Амплитуда[А]
Freq[Hz] = Частота[Гц]
Theta[1/s] = Период[1/сек]
Tdelay[s] = Пауза[сек]
Phi[deg] = Фаза[град]
Tperiod[s] = Tпериод[сек]
Ton[s] = Тон[сек]
Tfall[s] = Tспада[сек]
Trise[s] = Tнараст[сек]
Von[V]
Von[A]
Vinitial[V]
Vinitial[A]
Vpulsed[V]
Vpulsed[A]
Rise Delay[s]
Rise Tau[s]
Fall Delay[s]
Fall Tau[s]
Carrier Freq[Hz]
Modulation Index = Коэффициент модуляции
Signal Freq[Hz] = Частота сигнала[Гц]
Time[s] = Время[сек]
Value[V] = Значение[В]
Value[A] = Значение[А]
Waveforms = Форма сигналов
Duty cycle[%] = Скважность[%]
Amplitude[Vp] = Амплитуда[Vp]
Offset[V] = Смещение[V]
Rise/Fall Time[sec] = Время нараст/спада[сек]
Capacitance[F] = Емкость[Ф]
sComponent =
Inductance[H] = Индуктивность[Гн]
Gbw =
Slewrate = Скорость нарастания
Avol =
Rout(Ω) = Rвых[Ом]
Rin(Ω) = Rвх[Ом]
Ibias[A]
Inhi[V]
Inlo[V]
Isc[A]
Outhi[V]
Outlo[V]
Vabsmax[V]
Vmin[V] = Vмин[В]
Iq[A]
Cin[F] = Cвх[Ф]
high = высокий
low = низкий
Oscilloscope = Осциллограф
Logic Analyzer = Логический анализатор
Channel_A = Канал_А
Channel_B = Канал_Б
Channel A = Канал А
Channel B = Канал Б
Time = Время
Reverse = Инверсия фона
Simulation file exceed = Превышен размер файла с симуляцией
The simulation file is too large and has been stopped for performance reasons. = Файл моделирования слишком велик и был остановлен по соображениям производительности.
Timebase = Развёртка
Scale: = Маштаб
X pos.(Div): = X позиция (Дел):
Y pos.(Div): = Y позиция (Дел):
View meter... = Просмотр измерений...
The circuit has components without simulation model: = Эта цепь содержит элементы, которые не имеют модели для проведения симуляции
Your simulation interval is too short to simulate, please wait 5 seconds later and try again; if still show this message, may be you simulated over 500 times the maximum simulation times per day. = Интервал симуляции слишком короткий, пожалуйста, подождите 5 секунд и  повторите снова; если данное сообщение появляется снова, возможно вы превысили лимит по запуску симуляции в 500 раз в день.
Resistor1_US = Резистор1_US
Resistor1_EU/IEC = Резистор1_EU/IEC
Resistor1_3D = Резистор1_3D
Capacitor1_US = Конденсатор1_US
Capacitor1_EU/IEC = Конденсатор1_EU/IEC
Capacitor1_3D = Конденсатор1_3D
Rheostat_US = Реостат_US
Rheostat_EU/IEC = Реостат_EU/IEC
Rheostat_3D = Реостат_3D
Capacitor_Electrolytic_US = Конденсатор_Электролитический_US
Capacitor_Electrolytic_EU/IEC = Конденсатор_Электролитический_EU/IEC
Capacitor_Electrolytic_3D = Конденсатор_Электролитический_3D
Inductor_US = Индуктор_US
Inductor_EU/IEC = Индуктор_EU/IEK
Inductor_3D = Индуктор_3D
Resistor2_US = Резистор2_US
Resistor2_EU/IEC = Резистор2_EU/IEK
Resistor2_3D = Резистор2_3D
Multimeter = Мультиметр
Multimeter_3D = Мультиметр_3D
Oscilloscope = Осциллограф
Oscilloscope_3D = Осциллограф_3D
Signal_Generator = Генератор_cигналов
Signal Generator_3D = Генератор Сигналов 3D
Wattmeter = Ваттметр
Wattmeter_3D = Ваттметр_3D
NSSWS1080T_3D =
Voltage_Source_VDC = Источник_Напряжения_VDC
Voltage_Source_VSin = Источник_Напряжения_VSin
Voltage_Source_VPULSE = Источник_Напряжения_VPULSE
Voltage_Source_VEXP = Источник_Напряжения_VEXP
Voltage_Source_VSFFM = Источник_Напряжения_VSFFM
Voltage_Source_VPWL = Источник_Напряжения_VPWL
Voltage_Source_V_Behavioral_Source =
Current_Source_IDC = Источник_Напряжения_IDC
Current_Source_ISin = Источник_Напряжения_ISin
Current_Source_IPULSE = Источник_Напряжения_IPULSE
Current_Source_IEXP = Источник_Напряжения_IEXP
Current_Source_ISFFM = Источник_Напряжения_ISFFM
Current_Source_IPWL = Источник_Напряжения_IPWL
Current_Source_I_Behavioral_Source =
CCCS_1 = CCCS_1
CCCS_2 = CCCS_2
CCVS_1 = CCVS_1
CCVS_2 = CCVS_2
VCCS = VCCS
VCVS = VCVS
Three_Phase_Wye_Load = Трехфазная_нагрузка_звезда
Three_Phase_Delta_Load = Трехфайзная_нагрузка_дельта
78XX = 78XX
79XX = 79XX
555 = 555
555_3D = 555_3D
Transformer_US = Трансформатор_US
Transformer_EU/IEC = Трансформатор_EU/IEC
Transformer_Center_Tapped_US = Трансформатор_Center_Tapped_US
Transformer_Center_Tapped_EU/IEC = Трансформатор_Center_Tapped_EU/IEC
Mutual_Inductor_US =
Mutual_Inductor_EU/IEC =
Mutual_Inductor2_US =
Mutual_Inductor2_EU/IEC =
OR2EE_US =
OR3EE_US =
OR4EE_US =
OR2EE_CN =
OR3EE_CN =
OR4EE_CN =
NOR2EE_US =
NOR3EE_US =
NOR4EE_US =
NOR2EE_CN =
NOR3EE_CN =
NOR4EE_CN =
AND2EE_US =
AND3EE_US =
AND4EE_US =
AND2EE_CN =
AND3EE_CN =
AND4EE_CN =
NAND2EE_US =
NAND3EE_US =
NAND4EE_US =
NAND2EE_CN =
NAND3EE_CN =
NAND4EE_CN =
XOR2EE_US =
XOR2EE_CN =
XNOR2EE_US =
XNOR2EE_CN =
Digital_Clock_1Hz = Цифровое_тактирование_1Гц
Logicstate_0 =
Logicstate_1 =
Logic_Probe =
Buffee =
INVEE_US =
INVEE_CN =
Schmittbuffee =
LM358N_US =
LM358N_CN =
OPAMP3PEE_US =
OPAMP3PEE_CN =
OPAMP5PEE_US =
OPAMP5PEE_CN =
Voltage_Controlled_Switch =
Current_Controlled_Switch =
FUSE =
Delay_Fuse =
Transmission_Line =
Crystal =
DFFEE =
TFFEE =
JKFFEE =
SRFFEE =
SRLATCHEE =
SRNANDFFEE =
SRNORFFEE =
INVTSEE =
INVODEE =
Cbuffer =
SPDT_Open =
SPDT_Close =
SPST_Close =
SPST_Open =
Fast_Crystal =
Lamp = Лампа
BCD_Segment =
Seven_Segment = Семисегментный индикатор
Traffic_Light = Светофор
Lamp Settings = Настройки лампы
Power[W] = Мощность[Вт]
Dropout Voltage[V] = Падение напряжения[В]
Current[A] = Ток[А]
Threshold[V] = Пороговое напряжение[В]
Clock Rate = Тактовая частота
TrafficLight Settings =
BCDSegment Settings =
SevenSegment Settings = Настройки семисегментного индикатора
SPDT Settings =
SPST Settings =
LogicAnalyzer Settings = Настройки логического анализатора
Fuse Settings = Настройки Предохранителя
Wattmeter Settings = Настройки Ваттметра
open = открыт
close = закрыт
Common Anode = Общий Анод
Common Cathode = Общий Катод
AC Amplitude = Амплитуда Переменного Тока
AC Phase = Фаза Переменного Тока
There are some parts haven't spice model, please use "EElib" and "Spice Symbol" at "Libraries" of "Simulation" mode, or you can assign the spice model for them: = Некоторые элементы не имеют SPICE-модели, пожалуйста используйте "EElib" и "Spice Symbol" в "Libraries" из Режима Симуляции, или присвойте им SPICE-модель

#Pin
Pin Properties = Параметры контакта
Orientation = Ориентация
Line 45° = Линия 45°
Line 90° = Линия 90°
Arc 45° = Дуга 45°
Arc 90° = Дуга 90°
Free Angle = Свободный угол
Start X = Начало по X
Start Y = Начало по Y
Length = Длина
Name = Имя
name = имя
Number = Номер
Spice Pin Order = Spice Порядок Контакта
Display Number = Отображаемый Номер
Clock = Часы
Show = Показать
Electric = Электрический

#Junction
Junction Properties = Параметры соединения
X Location = Позиция по X
Y Location = Позиция по Y
Size = Размер
Color = Цвет

#Net Label
Net Label = Имя Цепи

#Part
Prefix = Префикс

#Image Properties and Dialog
Add Image = Добавить Изображение
Image Properties = Параметры Иизображения
Image URL = URL Изображения
Input an image URL = Введите URL изображения
Invalid image URL = Некорректный URL изображения
Invalid Prefix = Некорректный Префикс
Failed to load the image = Не удалось загрузить изображение
Image URL contains special characters = URL изображения содержит спецсимволы
From Web URL = По ссылке из Web
From Local Computer = С устройства
Please select a png/gif/jpg file. = Пожалуйста, выберите png/gif/jpg файл.
Please select an image file. = Пожалуйста, выберите файл изображения.
Select an image file = Выберите файл изображения
Insert Image to PCB = Вставить изображение на плату
Tolerance = Допуск
tolerance = допуск
capacitance = ёмкость
frequency = частота
Rated Voltage = Номинальное напряжение
Rated Current = Номинальный ток
resistance = сопритивление
Resistance = Сопротивление
Resistance[Ω] = Сопротивление[Ом]
inductance = индуктивность
Operating Temperature = Рабочая температура
Shape Invert = Инвертирование формы
Image Size = Размер изображения
Color Tolerance = Допуск цвета
Simplify Level = Понизить уровень
Corner Threshold = Ограничитель размера угла

#PCB Canvas Properties
Units = Единицы
Snap Size = Размер привязки
Other = Другое
Routing Width = Ширина Дорожки
[router]
Routing Width = Ширина Дорожки
[/router]
Please using hotkey {0}{key1}{1} or {2}{key2}{3} to change track width while on routing. = Пожалуйста, используйте горячую клавишу {0}{key1}{1} или {2}{key2}{3}, чтобы изменить ширину дорожки во время маршрутизации.
Routing Angle = Угол поворота
Routing Conflict = Конфликт Трассировки
Remove Loop = Удалить петлю
Cut SilkScreen = Вырезать Шелкографию
Grid = Сетка
Grid 90 = Сетка 90 градусов
Grid 45 = Сетка 45 градусов
Copper Zone = Медная зона
Visible = Видимая
Invisible = Невидимая
Ignore = Игнорировать
Block = Блокировать
RoundTrack = Округление Дорожки

#Track
Track Properties = Параметры дорожки
Layer = Слой
Net = Цепь
Start X = Начало по X
Start Y = Начало по Y
End X = Конец по X
End Y = Конец по Y
ID = ID

#Pad Properties
Pad Properties = Параметры полигона
Shape = Форма
Hole(D) = Отверстие (D)
Center X = Центр по X
Center Y = Центр по Y
Round = Круг
Oval = Овал
Hole Shape = Форма отверстия
Slot = Slot
Hole(Length) = Отверстие (глубина)
Plated = Plated
None = Нет
Paste Mask Expansion = Вставить расширение маски
Solder Mask Expansion = Размер окна в трафарете для защитной маски

#Via Properties
Via Properties = Свойства переходного отверстия
Diameter = Диаметр переходного отверстия
Drill Diameter = Диаметр сверла

#Hole Properties
Hole Properties = Параметры отверстия


#TEXT
Text Properties = Свойства текста
Line Width = Ширина линий
Rotation = Поворот
Fonts Management = Настройка Шрифтов

#Dimension Properties
Dimension Properties = Параметры измерения

#Footprint Properties
Component Properties = Параметры Компонента
Display Prefix = Отображаемый Префикс
Pin Name = Имя Контакта
Pin Number = Номер Контакта
Spice Pin Number = Номер Контакта Spice
Graphics = Графика
Pattern = Шаблон

Pin: = Контакт:
Netflag: = Флаг Цепи
Netlabel: = Метка Цепи
NetPort: = Порт Цепи
Voltage Probe: = Пробник напряжения
Pin: = Контакт:
Hidden Pin: = Скрытый контакт:
Unknown: = Не назначен:
#Arc Properties
Arc Properties = Параметры Дуги
Start Angle = Начало Угла
End Angle = Конец Угла
Rotation Direction = Направление Вращения

#Rect Properties
Rect Properties = Параметры Прямоугольника
Round radius = Радиус Скругления

#Circle Properties
Circle Properties = Параметры Круга
Radius = Радиус

#CopperArea Properties
CopperArea Properties = Параметры медной области
Clearance = Зазор
Pad Connection = Подключение Контакта
Direct = Прямое
Spoke = Ступенька
Keep Island = Сохранять островок
Fill Style = Стиль заполнения
CopperArea conflict: copper area outlines in same layer with different net names must not overlap = Конфликт медной области: контуры медных областей в одном слое с разными именами цепей не должны перекрываться.
Copper area rebuild complete! You can set "Copper Zone" as "Visible" at the right-hand property panel after single click the empty area. = Перестроение медной области завершено! Вы можете установить "Медная Зона" как "Видимая" на правой панели свойств после одного щелчка по пустой области.
Please create board outline first. = Пожалуйста, сначала создайте границы платы.
Board outlines are not closed. = Границы платы не замкнуты.
Rebuild CopperArea = Перестроить медную область
Edit Points = Редактировать точки
Direct = Напрямую
Spoke = Ступенька
No Solid = Не заполнять
Board Cutout = Граница платы
Solid = Сплошной
[copperArea]
None = Нет
[/copperArea]

#Custom Properties
Custom Properties = Пользовательские параметры
Fixed Properties = Фиксированные параметры
Add new parameter = Добавить новый параметр
Add New Parameter = Добавить новый параметр
Add New Supplier = Добавить нового поставщика
Mounted = Установлен
Unknown = Неизвестно

Custom = Пользовательский
Scan the QR code below and open it on the mobile side = Сосканируйте QR-код указанный ниже и откройте его на мобильном устройстве
How to create a single layer PCB = Как создать однослойную плату
Currently doesn't support layout single layer directly, please refer at: = В настоящее время нет поодержки однойслойных плат, смотрите информацию:

#Dialog Register
Create an account = Создать аккаунт
Username = Пользователь
Password = Пароль
Confirm Password = Подтвердить пароль
Email = Эл. почта
Please read this before you register = Пожалуйста, прочитайте это перед регистрацией
Hi {username} = Привет，{username}

#Dialog lostPassword
Lost Password... = Забыли пароль...
Find the password using your email = Восстановите пароль, используя Ваш email



#Dialog Login
Login = Логин
Username or Email = Имя пользователя или электронная почта
Remember Me = Запомнить меня
Third party = Третья сторона
Login and Register = Войти и зарегистрироваться
Your login information seems expired, please login again. Don't need to close the opening files, you can continue to save them after login. = Похоже, срок действие сессии истек, пожалуйста, войдите снова. Не нужно закрывать открытые файлы, Вы можете сохранить их после входа в систему.

#Dialog Reset Password
Reset a password using your email = Сбросить пароль, используя ваш email
Your registered email = Ваш зарегистрированный email

#Dialog Reaction
Re-send an activation code to your email = Повторно отправить код активации на вашу email

#Dialog Invite
Invite friends to register = Пригласить друзей зарегистрироваться
Your friend's email = Эл. почта вашего друга

#Dialog Add A New Parameter
Add a new parameter = Добавить новый параметр
Key = Ключ
Value.new_para = новый параметр
In BOM = В BOM-е
Add into BOM = Добавить в BOM
Invalid key = Неправильный ключ
This field is required. = Это поле обязательное.

#Dialog Change Your Password
Change your password = Изменить Ваш пароль
Old password = Старый пароль
New Password = Новый пароль
Confirm Password = Подтвердите пароль

#Dialog Create New Design
Save as a New Project = Сохранить как новый проект
Save as a schematic = Сохранить как схему
Save as Symbol = Сохранить как символ
Save as a spice Symbol = Сохранить как символ spice
Save as a spice subckt = Сохранить как подсхему spice
YOU MUST CREATE A SPICE SYMBOL WITH EXACTLY THE SAME NAME AS THIS SUBCKT = ВЫ ДОЛЖНЫ СОЗДАВАТЬ СИМВОЛ SPICE  С ТОЧНО ТАКИМ ЖЕ ИМЕНЕМ КАК И ЭТА ПОДСХЕМА
Save as a PCB file = Сохранить как файл платы
Save as Footprint = Сохранить как посадочное место
Save as a Schematic Module = Сохранить как схемный модуль
Save as a PCB Module = Сохранить как модуль платы
Save as 3D Model = Сохранить как 3D модель
Save as a WaveForm = Сохранить как звуковой образец
Title = Название
Share = Поделиться
Add file = Добавить файл
Visibility = Видимость
Allow Comments = Разрешить комментарии
Public (Anyone can see this project but only you can modify it.) = Публично (Каждый может видеть этот проект, но только Вы можете вносить изменения)
Private (Only you can see and modify this project) = Приватный (Только вы можете просматривать и редактировать этот проект)
Create new project success! = Новый проект создан!
You can now create files under this project = Теперь Вы можете создавать файлы в этом проекте
This file must be saved under a project, choose other project or create a new project = Этот файл необходимо сохранить в рамках проекта, выбрать другой проект или создать новый проект
Please login to save this kind of document = Пожалуйста, войдите, чтобы сохранить этот вид документа
Duplicated project title = Повторяющееся название проекта
#Duplicated document title
Project does not exist = Проект не существует
Document does not exist = Документ не существует
document not exists = документ не существует

Categories = Категории
Project = Проект
Short description = Краткое описание
Content = Контент
Modify this project info. = Изменить информацию об этом проекте.
Modify this file info. = Изменить информацию об этом файле.
Notice = Обратите внимание
Search for it before creating a new one. = Найдите его, прежде чем создавать новый.
Manufacturer Part Number = Номер детали производителя
Supplier = Поставщик
Or = Или
Supplier Part = Поставщик компонента
Supplier Part Number = Номер компонента у поставщика
Link = Ссылка
link = ссылка
The professional function please refer at: = Посмотреть описание профессиональной функции:

#Dialog Clone My Part
#Clone it to a project
#Clone it, then edit it
Clone your file = Клонировать файл

#Dialog Subckt
Attach a Subckt to this spice symbol = Прикрепите подсхему к этому символу spice
Subckt string = Строка подсхемы
Spice symbol title just allow [0-9][a-z][A-Z] and _ = В названии разрешено использоватьтолько [0-9][a-z][A-Z] и _

#Design Manager
Design Manager = Менеджер проекта
Nets = Цепи
DRC Errors = DRC ошибки
Are you sure you want to unroute this net? = Вы действительно хотите отменить трассировку этих соединений?
Unroute = Отменить трассировку
Track Length = Длина дорожки
Via/Hole Outer Size = Наружный размер Перехода/Отверстия
Filter nets = Фильтр соединений
Design Rule Checking = Проверка правил проектирования
Board Outline = Граница печатной платы
Plane Zone = Область разделения
[drcRule]
Width = Ширина
DRC Width = Программа контроля проектных норм Ширина
Length = Длина
DRC Length = Программа контроля проектных норм Длина
Drill Diameter = Диаметр сверла
DRC Drill Diameter = Программа контроля проектных норм Диаметр сверла
Diameter = Диаметр
DRC Diameter = Программа контроля проектных норм Диаметр
Object = Объект
DRC Clearance = Программа контроля проектных норм Зазор
[/drcRule]
#It will take a while to unroute this net, do you want to continue?
More than one netlabel is found in wire, please checked whether this is correct, if you design it on purpose, please ignore this warning. = Одно или более имени соединения соответствует этому проводнику. Пожалуйста, проверьте правильно ли это. Если это вами задумано, то проигнорируйте это предупреждение
Incomplete net, a complete net should contain two or more pins, if you design it on purpose, please ignore this warning. = Неполное соединение, полное соединение должно содержать два или более контакта. Если это вами задумано, то проигнорируйте это предупреждение
This netlabel is not connected with any pin. = Это соединение не подключено ни к одному контакту.
Incomplete connection, please check. = Неполнота подключений, пожалуйста проверьте.
The clearance between two objects is less than the Design Rule Checking (DRC) clearance which has different nets. = Зазор между объектами меньше, чем определено правилами проверки (DRC) для зазора между соединениями
The diameter is less than Design Rule Checking (DRC) diameter = Диаметр меньше, чем определено правилами проверки (DRC) для диаметра
The drill diameter is less than Design Rule Checking (DRC) drill diameter = Диаметр сверловки меньше, чем определено правилами проверки (DRC), для диаметра сверловки
The track length is longer than Design Rule Checking (DRC) track length = Длина дорожки больше, чем определено правилами проверки (DRC) для длиныы дорожки
The track width is less than Design Rule Checking (DRC) track width = Ширина дорожки меньше, чем определено правилами проверки (DRC) для ширины дорожки

#Dialog Simulation
Show your simulation report = Показать отчёт о симуляции
Download netlist = Скачать netlist
Run = Запустить
Components = Компоненты

#Dialog Import
Import file from your computer = Импортировать файл с вашего устройства
Maximum file size: 30 MB = Максимальный размер файла: 30 Mб
Maximum file size: 100 MB = Максимальный размер файла: 100 Mб
Chose file = Выберите файл
File Operation = Операции с файлом
Import File = Импортировать файл
Extract Libs = Извлечь библиотеки
No Libs! = Нет библиотек!
Import File and Extract Libs = Импортировать файл и извлечь библиотеки
File type = Тип файла
The file size is too large. = Размер файла слишком большой.
Please selected the file type. = Пожалуйста, выберите тип файла.
No component was found! = Компонентов не найдено!
Import successfully = Успешно импортировано
Import failed = Импорт не удался
Click OK to continue with the import = Нажмите ОК, чтобы продолжить импорт.
Select None = Ничего не выбрано

#Dialog Modify Symbol Information
Modify symbol information = Изменить информацию о символе
Spice Prefix = Префикс Spice
Hide Pin = Скрыть контакт
Pin Manager = Менеджер контактов
When a power pin is hidden, it will be marked as netlabel, you don't need to wire it. If you use it as simulation, please show it or create a GND/VCC Net for it. = Когда контакт питания спрятан, он может иметь имя соединения и вам не нужно его соединять проводом. Если вы используете симуляцию, то отобразите контакт или создайте для этого область(Цепь) GND/VCC.
Assign = Назначить
Supplier.bom = Список поставщика
LCSC.bom =  Список LCSC
Price = Цена
Quantity.bom = Количество
Package.bom = Корпус
Components.bom = Компоненты
Manufacturer Part.bom = Название у производителя
Manufacturer.bom = Производитель

One-click Purchasing at LCSC = Покупка у LCSC в один клик
Order Parts = Заказ компонентов
Export BOM = Экспортировать BOM
Upload to LCSC ERP = Загрузить в LCSC ERP
No components, upload failed! = Нет компонентов, ошибка при загруке!
Upload to LCSC ERP failed, please try again later. = Ошибка при загрузке в LCSC ERP, пожалуйста повторите позже
Current BOM upload to Chip Manager of LCSC successfully, click "OK" button to access Chip Manager. = Текущий BOM загружен в Менеджер компонентов LCSC, нажмите кнопку "ОК" для доступа к Менеджеру компонентов.
Upload to LCSC ERP failed, found some components miss some properties value, please check property "Footprint, Manufacturer Part" value if exist. = Ошибка при загрузке в LCSC ERP, обнаружено, что в некоторых компонентах отсутствует значение некоторых свойств, проверьте значение свойства «Посадочное место, Производитель компонента», если оно существует.

Export PCB BOM = Экспорт PCB BOM
Export Schematic BOM = Экспорт схемного BOM
ID.bom = ID BOM
Name.bom = Название
[bom]
Name = Имя
LCSC Assembly = Сборка LCSC
Value = Номинал
ID = ID
Supplier = Поставщик
LCSC = LCSC
Price = Цена
Quantity = Количество
Package = Корпус
Components = Компоненты
Manufacturer = Производитель
[/bom]
Manufacturer Part = Название у производителя

#Dialog Run
Run your simulation = Запустить вашу симуляцию
Transient = Скоротечный
Maximum Timestep = Максимальный размер шага
Stop Time = Время остановки
Start Time = Время запуска

AC Analysis = Анализ AC
Type of Sweep = Тип развертки
Number of points = Количество точек
Start Frequency = Начальная частота
Stop Frequency = Конечная частота

DC sweep = Анализ DC
Source to Sweep = Источник для развертки
Start Value = Начальное значение
Stop Value = Конечное значение
Increment = Приращение
DC Transfer = DC Transfer
Output = Выход
Source = Источник

DC op pnt = DC рабочая точка
Compute the DC operating point treating capacitances as opens and inductances as shorts = Вычисляет рабочую точку постоянного тока, считая ёмкости открытыми, а индуктивности не имеющими сопротивления

#Dialog Share Info
Active File = Активный файл
Active Project = Активный проект
Readonly = Только для чтения
Editable = Редактируемый
Active file's owner project page = Страница проекта, к которому принадлежит текущий документ
Active project editor page = Страница редактирования активного проекта

#Dialog Document Recovery
All Projects = Все проекты
Document Recovery = Восстановление файла
Unsaved files = Несохранённые файлы
Please select a file! = Пожалуйста, выберите файл!
Please expand the folder first, then select a document to recover. = Сначала откройте папку, затем выберите документ для восстановления.
Are you sure you want to remove this backup? = Вы уверены, что хотите удалить эту резервную копию?

#Dialog Find Libs
Search = Поиск
Search Results = Результаты поиска
Search and press Enter = Нажмите Enter для поиска
Keywords at least 3 characters = Ключевое слово должно содержать минимум 3 символа
Assembled = Собранный
Verified = Подтверждено
In stock = В наличии
{page} of {pagecount} pages = страница {page} из {pagecount} страниц
Common Modules = Стандартные модули
User Contributions = Добавленные пользователем
More = Больше
Modify Model... = Изменить модель...
Add Favorite = Добавить в избранное
Remove Favorite = Удалить из избранного
Add Sub Part = Добавить подкомпонент
Untagged = Без тегов
Package = Корпус
package = корпус
Title(PartNO) = Наименование(номер детали)
No Data! = Нет данных!
Quantity = Количество
Manufacturer Part = Наименование детали
manufacturer Part = наименование детали
Manufacturer = Производитель
manufacturer = производитель
voltage = напряжение
Library = Библиотека
LCSC Assembled = Собранный LCSC
JLCPCB Assembled = Собранный JLCPCB
User Contributed = Добавлено пользователем
Symbol = Символ
Follow = Отслеживать
Types = Типы
Classes = Классы
power = мощность
Power = Мощность
LCSC Part# = LCSC Код#
Stock = Наличие
Report Error... = Сообщить об ошибке...
Report Error = Сообщить об ошибке
Thanks for your feedback! = Спасибо за Ваш отзыв!
Report error success, thanks for your report! = Сообщение об ошибке отправлено, спасибо за ваше сообщение!
The content must be at least 2 characters! = Содержимое должно содержать не менее 2 символа!
This library is user contributed, please check before using. = Эта библиотека предоставлена пользователем, пожалуйста, проверьте перед использованием.
[lib]
All = Все
System = Система
Personal = Личное
Created = Созданный
Favorite = Избранное
No Team found. Please join or create a team first. = Группа не найдена. Пожалуйста, присоединитесь или создайте сначала группу.
Create a team = Создать группу
No follow user found. Please follow your friend first. = Не найдено подписчиков. Пожалуйста, сначала подпишитесь на вашего друга.
[/lib]


BUY = КУПИТЬ
In Stock = В наличии
Out of Stock = Нет в наличии
Minimum = Минимум
Distributor = Дистрибьютор

Capacitance = Емкость
Frequency Tolerance = Точность частоты
Power (Watts) = Мощность (Вт)
Power - Max = Мощность - Макс
Frequency = Частота
Voltage Rating(Vdc,Vac) = Уровень напряжения(пост., перем.)
Voltage = Напряжение
Current Rating = Уровень тока
Rated current = Номинальный ток
Resistance (Ohms) = Сопротивление (Ом)
Resistance(Ohms) = Сопротивление(Ом)
Inductance = Индуктивность
FET Type = Тип FET
Current Rating(Max) = Уровень тока(Макс)
Impedance @ Frequency = Индуктивность @ Частота
Voltage - Input (Max) = Напряжение - Входное (Макс)
Voltage - Input (Min) = Напряжение - Входное (Мин)
Voltage - Supply = Напряжение - Питание
Voltage - Max = Напряжение - Максимальное
Current - Output = Ток - Выходной

#Dialog Export Your Works
Export your works = Экспорт вашей работы
Export to = Экспорт в
Zoom = Масштаб
Image Type = Тип изображения
Qualify = Квалифицировать
0 means real size = 0 означает реальный размер
Merged layer = Объединённые слои
Separated layer = Разделенные слои
Paged layer = Каждый слой на отдельной странице
Layer = Слой
Export = Экспорт
Mirror = Зеркально
TopLayer = Верхний слой
BottomLayer = Нижний слой
TopSilkLayer = Верхняя шелкография
Protractor Properties = Свойства транспортира
BottomSilkLayer = Нижняя шелкография

BoardOutLine = Границы платы
TopAssembly = Размещение деталей сверху
BottomAssembly = Размещение деталей снизу
Mechanical = Механический
DocumentLayer = Слой документа
Inner{number} = Внутренний{number}
Substrate{number} = Подложка{number}
Color = Цвет
Full Color = Полноцветный
Canvas Setting = Настройки окна редактора
Full Graphics = Все в графическом виде
Assembly Drawings = Сборочные чертежи
Object Outlines = Границы Объекта
Invalid file format = Некорректный формат файла
Failed to export file = Не удалось экспортировать файл
Download now = Скачать сейчас
Wire Width = Ширина дорожек
Sheet = Лист
Merged sheet = Объединённый лист
Separated sheet = Отдельный лист
Engine = Программа
Exporting PDF = Экспортировать в PDF
Export 3D Model = Экспортировать 3D модель
[exportDocument]
Size = Размер
[/exportDocument]

#Dialog Import Changes
Confirm Importing changes information = Подтвердите импорт информации об изменениях
You can't undo this operation, Please run a Design Rule Checking (DRC) after this operation. = Вы не можете отменить эту операцию. Пожалуйста, запустите проверку правил проектирования (DRC) после этой операции.
Apply Changes = Применить изменения
This is a simple Design Rule Checking (DRC). = Это простая проверка правил проектирования (DRC).
It just can help you to find the obvious errors = Это проще пожет найти вам очевидные ошибки
There are some unfinished nets, do you want to check the nets first? = Есть несколько незавершенных цепей, вы хотите сначала проверить цепи?
Yes, Check Nets = Да, проверить Цепи
No, Keep Going = Нет, продолжить

#Dialog Layer Manager
Configured = Настраиваемое
Layer Name = Имя слоя
TopPasterLayer = Верхний слой пасты
BottomPasterLayer = Нижний слой пасты
TopSolderLayer = Верхний слой пайки
BottomSolderLayer = Нижний слой пайки
TopPasteMaskLayer = Верхний слой маски
BottomPasteMaskLayer = Нижний слой маски
TopSolderMaskLayer = Верхний слой паяльной маски
BottomSolderMaskLayer = Нижний слой паяльной маски
ComponentShapeLayer = Слой расположения компонента
LeadShapeLayer = Слой покрытия оловом
ComponentMarkingLayer = Слой маркировки
Ratlines = Линии связи
Ratlines Color = Цвет линий связи
Manage Colors = Настраиваемые цвета
BoardOutline = Границы платы
Multi-Layer = Многослойная
Hole = Отверстие
DRCError = Ошибка DRC
Setting = Настройки
Drawing area = Область рисования
Export area = Экспортировать область
Transparency(%) = Прозрачность(%)
Copper Layer = Медный слой
Signal = Сигнал
Plane = плоскость
Non-Signal = Несигнальный
Other = Другое
Please delete all the objects of the layers first! The layers are: = Пожалуйста, сначала удалите все объекты со слоев! Слои:
You are converting Signal Layer to Plane Layer, There're some non-track objects remain on following layers. Please delete the objects manually on the canvas. = Вы конвертируете сигнальный слой в слой Plane. На некоторых слоях остаются некоторые объекты без трассировки. Пожалуйста, удалите объекты вручную на холсте.
Please delete all the objects of this layer first! = Пожалуйста, сначала улалите все объекты с этого слоя!

#Dialog Fabrication Output
Create Files = Создать файлы
Check your {0}Gerber files{1} carefully before sending them to the factory = Внимательно проверьте ваши {0}Gerber-файлов{1} перед отправкой на производство
Download free Gerber Viewer (gerbv) = Скачать бесплатный Gerber Viewer (gerbv)
Before generating the Gerber files = Перед генерацией Gerber-файлов
Please check the packages size and orientation carefully. = Пожалуйста, внимательно проверьте размер компонентов и их положение.
Please check for Design Rule Checking (DRC) errors in the Design Manager. = Пожалуйста проверте правила трассировки (DRC) в менеджере дизайна платы.
Please rebuild the copper area after modifying tracks and packages. = Пожалуйста, перестройте медную область, после добавления дорожек и компонентов.
After generating the Gerber file, please use the {0}Gerber Viewer{1} to check whether it conforms to the design requirements. = После создания Gerber-файлов, пожалуйста, используйте {0}просмотрщик Gerber{1}, чтобы проверить, что соответсвуют вашим требованиям.
Order PCB/SMT = Заказать PCB/SMT на JLCPCB
Found the complicated polygon that object cannot be generated at Gerber, please remove or replace = Обнаружен сложный многоугольник, объект которого не может быть сгенерирован в Gerber, удалите или замените
ID: {id}, Object: {object}, Location: {location} = ID: {id}, Объект: {object}, Позиция: {location}

#Dialog DRC
Item = Элемент
Value = Номинал
value = значение
Unit = Единица
Track Width = Ширина дорожки
Track to Track = Дорожка к дорожке
Track to Pad = Дорожка к контакту
Pad to Pad = Контакт к Контакту
Via to Via = Переходное к переходному
Via Hole Size = Диаметр переходного отверстия
Realtime DRC = Realtime DRC
{0} is too small! = {0} слишком маленький!
Invalid DRC Rule = Ошибочное правило DRC
Rule = Правило
Via Diameter = Диаметр переходного отверстия
Via Drill Diameter = Диаметр сверловки переходного отверстия
Net List = Список Цепей
Rule = Правило
Set Rule = Установить правило
Check Object to Copper Area = Проверить объект в медной области
Show DRC Boundary while Routing = Показывать границу DRC при трассировке
Check Object to Board Outline = Показать объект на линии границы платы
Rule name already exists! = Имя правила уже существует!
You should not delete default rule! = Вы не можете удалить правило по-умолчанию!
Rule list contains invalid rule setting! = Список правил содержит неправильные настройки!
Duplicate rule name exists! = Существует дубликат в имени правил!
via diameter is smaller than via drill diameter! = Диаметр переходного отверстия меньше, чем диаметр сверла переходного отверстия!
Currently rule name is not allowed to contain magical characters like . and $ = Текущее имя правила не разрешено из-за содержащихся в нем спец. символов, таких как . и $
[drcRule]
All = Все
[/drcRule]

#Dialog Hotkey
Change Canvas Unit = Изменить единицы иземерния рабочего поля
Copy Selected Object(s) by Reference Point = Копировать выбранный(е) объект(ы) по контрольной точке
Fullscreen = Во весь экран
Undo the Previous Draw = Отменить предыдущие действия на чертеже
Set Canvas Origin by Coordinate = Установить начало холста по координате
Switch to the Next Signal Layer = Перейти на следующий сигнальный слой
Switch to the Previous Signal Layer = Перейти на предыдущий сигнальный слой
Switch object to top layer or bottom layer = Перенести объект на верхний или нижний слой
Cycle Forward to the Next Open Tabbed Document = Циклический переход вперед к следующему открытому документу с вкладками
Cycle Backward to the Previous Open Tabbed Document =  Циклический переход назад к предедыщему открытому документу с вкладками
Switch to the Previous Layer(on the Numeric Keypad) = Перейти на предыдущий слой (на цифровой клавиатуре)
Switch to the Next Layer(on the Numeric Keypad) = Перейти на следующий слой (на цифровой клавиатуре)
Toggle Layers Which is Not Active = Переключение слоев, которые не активны
Hotkey Setting = Настройки горячих клавиш
Document Type = Тип документа
Shortcut = Ярлык
Function = Функция
ALL = ВСЕ
SCH = SCH
Rotate Selected Objects = Повернуть выделенные объекты
Scroll or Move Selected Left = Пролистать или Передвинуть Выделенное Влево
Scroll or Move Selected Right = Пролистать или Передвинуть Выделенное Вправо
Scroll or Move Selected Up = Пролистать или Передвинуть Выделенное Вверх
Scroll or Move Selected Down = Пролистать или Передвинуть Выделенное Вниз
Set canvas origin to the center grid of graphics in symbol; Set canvas origin to the center of pads in footprint. = Установите исходную точку холста в центральную сетку графики в символе; Установите начало холста в центре контактных площадок в посадочном месте.
Cross Document Paste = Вставить из другого документа
Explore & Find Components = Найти компоненты
Select All = Выделить всё
Cancel Current Drawing = Отменить текущий чертеж
Save = Сохранить
Drag Tool = Инструмент перетаскивания
Draw Wire = Нарисовать провод
Draw Bus = Нарисовать шину
Bus Entry = Ветка шины
Junction = Соединение
Net Flag GND = Флаг цепи GND
Net Flag = Флаг Цепи
Draw Polyline = Нарисовать полилинию
Draw Polygon = Нарисовать многоугольник
Draw Bezier = Нарисовать Безье
Draw Arc = Нарисовать дугу
Draw Rect = Нарисовать прямоугольник
Draw Ellipse = Нарисовать овал
Freehand Draw = Свободное рисование
Freedraw = Свободное рисование
Draw Text = Нарисовать текст
Edit Selected Symbol = Редактировать выбранный Symbol
Draw Track = Нарисовать дорожку
Draw Circle = Нарисовать круг
Cycle Select Object at Current Location = Циклический выбор объекта в текущей позиции
Draw Dimension = Нанести размеры
Draw Connect = Нанести соединение
Draw CopperArea = Нанести медную область
Change to TopLayer;<br/>Change Selected Component's Layer to TopLayer; = Изменить на верхний слой;<br/>Изменить слой выбранного компонента на верхний слой;
Change to BottomLayer;<br/>Change Selected Component's Layer to BottomLayer; = Изменить на нижний слой;<br/>Изменить слой выбранного компонента на нижний слой;
Change to Inner1 = Изменить на Внутренний1
Change to Inner2 = Изменить на Внутренний2
Change to Inner3 = Изменить на Внутренний3
Change to Inner4 = Изменить на Внутренний4
Highlight Net = Подсветить Цепь
Highlight Network = Подсветить Цепь
Unhighlight Network =Выключить подсветку Цепи
Place Pad = Разместить площадку
Place Via = Разместить переходное отверстие
Measure = Измерить
Change Routing Angle = Измерить угол поворота
Change Routing Conflict = Изменить конфликты трассировки
Decrease Routing Width = Уменьшить ширину дорожки
Increase Routing Width = Увеличить ширину дорожки
Decrease Snap Size = Уменьшить размер привязки
Increase Snap Size = Увеличить размер привязки
Change Copper Zone Visible or Invisible = Изменить медную зону на Видимая или Невидимая
Rebuild All Copper Area = Перестроить все медные области
Toggle PCB Net Display = Переключить отображение Цепей печатной платы
Show Property Dialog When Placing Object;<br/>Show Location Setting Dialog When Pasting Object(s) = Показать диалоговое окно свойств при размещении объекта;<br/>Показать диалоговое окно настройки местоположения при вставке объекта(ов)
Show Property Dialog When Placing Object;<br/>Show Absolute Offset Dialog When Selecting Object(s);<br/>Show Location Setting Dialog When Pasting Object(s) = Показать диалоговое окно свойств при размещении объекта;<br/>Показать диалоговое окно абсолютного смещения при выборе объекта(ов);<br/>Показать диалоговое окно настройки местоположения при вставке объекта(ов)
Show Relative Offset Dialog When Selecting Object(s) = Показать диалоговое окно относительного смещения при выборе объекта(ов)
Open the FAQ Page = Открыть страницу FAQ
Move Object(s) by Reference Point = Переместить объект(ы) по контрольной точке
Choose Favorite Track Width While Routing = Выберите избранную ширину дорожки при трассировке
Copy Selected Object(s) and Paste Repeatedly = Копировать выбранные объект(ы) и вставлять повторно

#My Projects Tree Menu
New Project = Новый проект
New Schematic = Новая схема
New PCB = Новая плата
New Spice Subckt = Новая подсхема Spice
Modify = Изменить
Delete = Удалить
Add sub part = Добавить подкомпонент
Clone = Клонировать
Version History = История изменений
Refresh List = Обновить список
Create New Project = Создать новый проект
Delete = Удалить
Attachment = Вложение
Archive = Архив
Transfer = Переместить
Manage Project = Управление проектом

#Dialog Verify Package
Footprints Verification = Проверка посадочных мест

#Dialog Edit Polygon Pad points
Edit Points = Редактировать точки
Center point is outside the pad = Центральная точка за пределами области контактной площадки
Hole should be inside the pad = Отверстие должно быть внутри области контакта
Hole is draggable = Отверстие перемещаемо

#My Part Tree Menu
Clone = Клонировать
Reload parts = Перезагрузить части
Layers = Слои

#Dialog Preferences
Language = Язык
Display Name = Отображаемое имя
HotKey Sync = Синхронизация горячих клавиш
My Theme Sync = Синхронизация моих Тем
Document Recovery Setting = Настройка восстановления документа
Enable auto backup = Разрешить автосохранение
Maximum backup level = Максимальный уровень сохранения
Auto backup interval = Интервал автосохранения
minutes = минуты
Save to Server = Сохранять на сервере
Load from Server = Загрузить с сервера


#Dialog Schematic Library Wizard
Symbol Wizard = Мастер компонентов
Style = Стиль
Picture = Изображение
Pin Names = Имена контактов
Contributor = Помощник
contributor = помощник
owner = владелец

#Dialog Annotate
Annotate = Замечание
Scope = Область
All pages = Все страницы
Current page only = Только текущая страница
Selected components = Выбранные компоненты
All Opened Schematics = Все открытые схемы
Method = Метод
Re-annotate all = Обновление всех заметок
Keep existing annotation = Оставить существующую аннотацию
Direction = Направление
Rows = Строки
Cols = Столбцы
Reset = Сбросить

#Dialog Order
Order... = Заказать...
PCB Qty. = Количество плат
PCB Thickness = Толщина текстолита
PCB Dimension = Размеры платы
Automatic calculation = Автоматический расчёт
PCB Color = Цвет паяльной маски
Green = Зелёный
White = Белый
Blue = Голубой
Red = Красный
Yellow = Жёлтый
Black = Чёрный
Purple = Фиолетовый
Copper = Медь
Gold = Золото
Silver = Серебро
Surface Finish = Финишное покрытие
Hasl = Горячее лужение
Hasl(Lead Free) = Горячее лужение (без свинца)
ENIG = Иммерсионное золото ENIG

#Dialog Hot Key config
Restore All Default Shortcuts = Восстановить клавиши по-умолчанию
Save Changes = Сохранить изменения



#Dialog Polyline Maybe Wire
To connect electrical elements, please use Wire (W hotkey) and not Line (L hotkey). = Чтобы соединять электронные компоненты, пожалуйста, используйте Провод (клавиша W), а не Линию (клавиша L).

Anonymous File = Анонимный файл
Anonymous File can not be cloned, but you can open it, then save it as a new file. = Анонимный файл не может склонирован, но Вы можете открыть его, затем сохранить как новый файл.
Free Documents = Свободный документ
You must close the file before delete it! = Вы должны закрыть файл перед его удалением!
Offline Project = Оффлайн-проект

#Message box
Confirmation = Подтверждение
Alert = Внимание
Information = Информация
information = информация
Prompt = Запрос
Error = Ошибка
error = ошибка
error! = ошибка!
Warning = Предупреждение
Imported ok! = Импортирование успешно!
Some changes have not been saved. = Некоторые изменения не были сохранены.
Your file hasn't been saved. Please save first! = Ваш файл не сохранён. Пожалуйста, сначала сохраните его!
Your file hasn't been saved. Are you sure you want to close it? = Ваш файл не был сохранен. Вы уверены, что хотите закрыть его?
Error! Please try again later. = Ошибка! Пожалуйста, попробуйте ещё раз.
Are you sure you want to reload this page? = Вы действительно хотите перезагрузить эту страницу?
Are you sure you want to leave this page? = Вы действительно хотите покинуть эту страницу?
Confirm Reload = Подтвердить перезагрузку
Confirm Close = Подтвердить закрытие
Reload this page = Перезагрузить данную страницу
Leave this page = Покинуть эту страницу
Stay on this page = Остаться на этой странице
Don't reload = Не перезагружать
No connect flag only can be placed on Pin dot or the wire which is connected one Pin. = Флаг "не подключен" может быть установлен только на контакт или провод, который подключен к одному контакту.
can not be placed on the wire which is placing No Connect Flag. = не может быть размещен на проводе с установленным флагом "Не подключен".
The footprint transfer to LCSC library class successfully = Успешный перенос посадочного места в библиотечный класс LCSC
Device/Footprint goes into "SMT Device/Footprint Verified" list successfully = Корпус/Посадочное место успешно размещено в список "Провереннный SMT Корпус/Посадочное место"

Load failure! = Загрузка не удалась!
Load projects failed = Загрузка проектов не удалась
error info = информация об ошибке
error information = информация об ошибке
Guest can't create a new project. Please login! = Гость не может создавать новый проект. Пожалуйста, выполните вход.
Please create a project before you do this! = Пожалуйста, создайте проект перед тем, как что-то сделать!
Add Part success = Компонент добавлен
Click the new part and then edit it! = Нажмите на новый компонент и затем отредактируйте его!
Delete my work = Удалить мою работу
Delete my work. (Only deletes it from this list but not from the server) = Удалить мою работу. (Удаляется только из этого списка, но не с сервера)
Do you confirm this? = Вы уверены?
Successfully deleted! = Успешно удалено!
Successfully Copied! = Успешно скопировано!
Cloning success! = Успешно клонировано!
Your title is too short! = Название слишком короткое!
Remove this part = Удалить эту часть
Find and Jump to ... = Найти и перейти ...
Please type the prefix, such as U1, R1, C1 = Пожалуйста укажите префикс, например U1, R1, C1
Zoom as 1:1, you can print it and then create artwork for etching the PCB. = Масштаб 1:1, вы можете напечатать его и затем создать шаблон для травления платы.
Exporting your works! = Экспорт ваших работ!
Guests can't import a file. Please login! = Гостьне может импортировать файл. Пожалуйста, выполните вход!
Please create a project before you import a file! = Пожалуйста, создайте проект перед тем, как импортировать файл!
Import your LTspice file! = Импорт вашего файла LTspice!
Open LTspice file = Открыть файл LTspice
Open EasyEDA file = Открыть файл EasyEDA
Please make sure the selected LTspice file is a file saved in LTspice V and above. = Пожалуйста, убедитесь, что выбранный файл LTspice является файлом, сохраненным в LTspice V и выше.
Saved successfully! = Сохранено успешно!
Save failed! = Ошибка сохранения!
Can not place parts into this document. = Не удалось вставить компоненты в этот документ.
User Package = Пользовательский корпус
System Package = Системный корпус
File error = Ошибка файла
Please save your file first! = Пожалуйста, сначала сохраните ваш файл!
Email address is too short! = Адрес эл. почты слишком короткий!
You have not selected a file to upload. = Вы не выбрали файл для загрузки.
Update = Обновить
No changes, the PCB already matches the schematic! = Никаких изменений, плата уже соответствует схеме!
Only public files can be shared = Можно делиться только публичными файлами
Conversion to PCB has failed! = Не удалось конвертировать в печатную плату!
Your username is too short! = Имя пользователя слишком короткое!
Your password is too short, it must be more than 6 characters! = Ваш пароль слишком короткий, он должен содержать более 6 символов!
Conflicting shortcut = Конфликт горячих клавиш
There is an empty PCB file. Please first run Convert Schematic to PCB... from the schematic = Пустой файл печатной платы. Пожалуйста, сначала запустите конвертацию проекта в плату... из схемы
This file has been modified, are you sure you want to run this simulation before saving it first? = Этот файл содержит изменения, вы уверены что хотите запустить симуляцию, перед тем как сначала сохранить его?
Please enter the Maximum Timestep! = Пожалуйста, введите максимальный размер шага времени!
Please enter the Stop Time! = Пожалуйста, введите время остановки!
All of these fields are needed. = Необходимо заполнить все эти поля.
Either your spice netlist is too big or the server is busy. Please try again later. = Либо ваш список spice-соединений  слишком велик, либо сервер занят. Пожалуйста, попробуйте позже.
Your spice netlist is too big! Try breaking your circuit into smaller simulatable blocks. = Ваш список spice-соединений слишком велик! Попробуйте разбить схему на более мелкие блоки симуляции.
Too many users in simulation. Please try again later! = Слишком много пользователей в симуляционном режиме. Пожалуйста, попробуйте позже!
Due to limited server resources, please wait 10 seconds for the interval in every time simulation. = Из-за ограниченных ресурсов сервера, пожалуйста, сделайте паузу в 10 секунд перед каждой симуляцией.
Your circuit is too complex, we have not enough CPU resource to support this simulation, please reduce your circuit as small as you can. = Ваша схема слишком сложна, у нас недостаточно ресурсов процессора для поддержки этой симуляции, пожалуйста, уменьшите вашу схему на сколько это возможно.
Simulation is queuing, try again after 30s. = Симуляция стоит в очереди, повторите попытку через 30 секунд.
Timeout = Тайм-аут
Demo accounts don't support simulation, please login first = Демо-аккаунт не поддерживает симуляцию, пожалуйста, сначала выполните вход
Please login first = Пожалуйста, выполните вход
The schematic is showing errors, please check the simulation report carefully! = Схема содержит ошибки, пожалуйста, внимательно проверьте отчет о симуляции!
Simulation too long, maybe your schematic is too complex. = Симуляция слишком долгая, возможно схема слишком сложна.
Non-simulated file = Файл без симуляции
This file can only be opened in standard mode. To open it, please switch to standard mode. = Этот файл может быть открыт только в стандартном режиме. Для его открытия, пожалуйся передключитесь в стандартный режим.
Load your preferences success! = Ваши настройки загружены!
Save your preferences success! = Ваши настройки сохранены!
Update subckt ok! = Подсхема обновлена!
Clone your file = Клонируйте свой файл
Please type a new file name = Пожалуйста, введите имя нового файла
Create file failure! = Ошибка создания файла!
Schematics and PCBs can't be imported under My Libs folder, please choose a different folder = Схемы и печатные платы не могут быть импортированы в папку Мои библиотеки, пожалуйста, выберите другую папку
Libraries to be imported under My Libs folder = Файлы библиотек могут быть импортированы только в папку Мои библиотеки
Please choose only the libraries needed = Пожалуйста, выберите только необходимые библиотеки
Maximum import is 200 libs at one time! = Нельзя импортировать более 200 библиотек за один раз!
You libraries will be found under the My Libs folder = Ваши библиотеки можно найти в папке Мои библиотеки
Add to Library = Добавить в библиотеку
No items have been checked! = Не выбран ни один элемент!
Nothing was found, please create it for yourself = Ничего не найдено, пожалуйста, создайте его сами
Search result = Результаты поиска
At least 3 characters needed = Необходимо как минимум 3 символа
Add to my Favorite Parts = Добавить в мои любимые компоненты
Added it OK. Please find it in your Favorite Parts = Успешно добавлено. Теперь вы сможете найти этот компонент в избранных компонентах
Please select its parent node = Выбирите родительский узел
Libraries can not be exported as active project pdf. = Библиотеки нельзя экспортировать как активный проект в формате pdf.
Error:No GND = Ошибка: Нет GND
This circuit does not have GND. Please select GND from the circuit tool to add to the circuit. = Эта схема не содержит GND. Пожалуйста выберите GND из инструментов для доавления в схему.
Current circuit doesn't has Voltage Resource or Current Resource symbol, please place it first at left side EElib or Spice Library. = Текущая схема не содержит символа источника напряжения или источника тока, пожалуйста, разместите его, выбрав его в левой части библиотеки EElib или библиотеки Spice.
Probe can not connect with ground(GND)! = Пробник не подключен к земле (GND)!
Spice symbols's properties can't be empty. = Свойство символа Spice не может быть пустым.
Error:No Spice Symbol = Ошибка: Не существует символа Spice
Simulation limit = Лимит симуляции
There is a multimeter in the circuit that needs to be simulated using the emulation command .tran or .op = В схеме есть мультиметр, который нужно симулировать с помощью команды эмуляции .tran или .op
An oscilloscope exists in the circuit and needs to be simulated using the simulation command .tran = В схеме присутствует осциллограф, и его необходимо симулировать с помощью команды симуляции .tran
There are components in this circuit that do not have a simulation model. Please use the base library component of the simulation mode for simulation. = В этой схеме есть компоненты, у которых нет модели симуляции. Пожалуйста, используйте компонент базовой библиотеки режима симуляции для симуляции.
Circuit does not have a probe = Схема не содержит пробника
Make sure your pin numbers are even numbers = Убедитесь, что количество контактов чётное
Duplicate Components Prefix = Дублирующий префикс компонента
All components are hidden successfully! = Все компоненты успешно скрыты!
All ratlines are hidden successfully! = Все линии связей  успешно скрыты!
Hidden the ratline of net {netName} successfully! = Спрятана линия связи Цепи {netName}!
Duplicate Component Prefix = Дублировать префикс компонента
{0} exist = {0} существует
Modify successfully, but {0} already exists = Изменение успешно, но {0} уже существует
There are some invalid packages, are you sure? = Есть несколько недопустимых корпусов, вы уверены?
Invalid Characters, library only allows [0-9a-zA-Z-_] = Недопустимые символы, библиотека допускает только [0-9a-zA-Z-_]
Annotation success = Аннотация сохранена
If you accept this annotation operation, please save your files. If not, close your files without saving. = Если вы принимаете эту операцию аннотации, пожалуйста, сохраните ваши файлы. Если нет, закройте файлы без сохранения.
This file can't be saved under libs project. Please choose other project or create a new project = Этот файл нельзя сохранить в проекте библиотеки. Пожалуйста, выберите другой проект или создайте новый
Your file is unsaved. = Ваш файл не сохранён.
You can close the editor now. Have a good day! = Теперь вы можете закрыть редактор. Хорошего дня!
Successfully logged out = Выход выполнен успешно
You have at least one unsaved file open. Please save it or close it. = У вас открыт как минимум один несохранённый файл. Пожалуйста, сохраните или закройте его.
Please select a reference point = Пожалуйста, выберите точку отсчета
Please save your file before this operation = Пожалуйста, сохраните ваш файл перед началом этого действия
Please open a PCB document = Пожалуйста, откройте файл с печатной платой
Please save your file before '{0}'. = Пожалуйста, сохраните файл перед тем, как '{0}'.
Please try again after saving this file. = Повторите попытку после сохранения этого файла.
This text can not be empty! = Этот текст не может быть пустым!
Export to Altium fail, please try again or contact us. = Не удалось экспортировать в Altium, повторите попытку или свяжитесь с нами.
Connecting to server = Подключение к серверу
Please login before asking for help = Пожалуйста, войдите, перед тем как попросить помощи
This file has been modified, please save it first! = Этот файл был изменён, пожалуйста, сначала сохраните его!
Remove this param = Удалить этот параметр
You cannot drag a part to the canvas, please click the part and move the cursor to the canvas and then right-click to place. = Вы не можете перетащить часть на холст, щелкните часть и переместите курсор на холст, а затем щелкните правой кнопкой мыши, чтобы разместить.
Undo/Redo temporary error = Ошибка Отмены/Повтора
We are sorry but there is an unpredictable error in the undo/redo process. This problem will be fixed soon but in the meanwhile it is safe to continue working on your design. = Сожалеем, но в процессе отмены/повтора произошла непредвиденная ошибка. Эта проблема будет исправлена в ближайшее время, а пока можно безопасно продолжать работу над своей разработкой.
The schematic has duplicate prefixes of the components, please make them unique. You can check them using the Design Manager. = На схеме есть повторяющиеся префиксы компонентов, сделайте их уникальными. Вы можете проверить их с помощью менеджера дизайна.
Found duplicated prefix components, can not Import Changes, please modify the duplicated prefix or delete related component. = Обнаружены повторяющиеся компоненты префикса, невозможно импортировать изменения, измените дублирующийся префикс или удалите связанный компонент.
Please click the below help button to find out how to fix this problem. = Нажмите кнопку справки ниже, чтобы узнать, как решить эту проблему.
Please create a board outline! Click the help button to find out how to create a board outline. = Пожалуйста, создайте границы платы! Нажмите кнопку справки, чтобы узнать, как создать границы платы.
Can not fetch files from server, please check your network and try again = Не удалось получить файлы с сервера, пожалуйста, проверьте ваше сетевое подключение и повторите попытку
Please open a schematic first! = Пожалуйста, сначала откройте схему!
Can not find the schematic of this PCB = Не удалось найти схему для этой печатной платы
invalid points! = недопустимые координаты!
This file does not support this operation. = Этот файл не поддерживает эту операцию.
Net Name Conflict = Конфликт имён Цепей
Net name = Имя Цепи
{0} are in the same wire, please remove others and just keep one. = {0} один и тот же провод, удалите другие и оставьте только один.
This field can't be removed! = Это поле не может быть удалено!
Annular ring of the pad/via is too small = Поясок контакта/переходного отверстия слишком мал
The size of the hole cannot exceed the size of the pad = Размер отверстия не может превышать размер контакта
Are you sure you want to create a multi-sheet designs? = Вы уверены, что хотите создать многостраничный дизайн?
Are you sure you want to create a {0}multi-sheet designs{1}? = Вы уверены, что хотите создать {0}листов дизайна{1}?
Please build the copper area! Click the help button to find out how to build the copper area. = Пожалуйста, постройте медную область! Нажмите кнопку справки, чтобы узнать, как построить медную область.
Suggest to set a package for this component first! = Предлагаем сначала установить пакет для этого компонента!
Please select an opened document first. = Сначала выберите открытый документ.
Some files failed to load. Please reload the page. = Некоторые файлы не удалось загрузить. Пожалуйста, перезагрузите страницу.

#UI Intro
Skip = Пропустить
« Back = « Назад
Next » = Вперёд »
Done = Готово
This is the user management menu. = Это меню управления пользовательскими настройками.
This is the toolbar. = Это панель инструментов.
This is the navigation list. Under here you can find projects, files, parts and libraries. = Это список навигации. Здесь вы можете найти проекты, файлы, компоненты и библиотеки.
Show or hide the toolbar to the top of the window here. = Показать или скрыть панель инструментов в верхней части этого окна.
Show, resize or hide the left sidebar to the left of the window here. = Показать, изменить размер или скрыть левую боковую панель слева от этого окна.
Show or hide the right sidebar to the right of the window here. = Скрыть/показать правую боковую панель справа от этого окна.

#Standard libs
Passive Components = Пассивные компоненты
Power Supply = Источник питания
Diodes = Диоды
Regulator = Регулятор
Transistor = Транзистор
Transformers = Трансформаторы
Gates = Лог. элементы
Vacuum Tubes = Ламповая электроника
Switch = Переключатели
Relay = Реле
Capacitor(US) = Конденсатор(США)
Capacitor(EU) = Конденсатор(ЕС)
Capacitor(EU)2 = Конденсатор(ЕС)2
Electrolytic Capacitor(US) = Электролитический конденсатор (США)
Electrolytic Capacitor(EU) = Электролитический конденсатор (ЕС)
Electrolytic Capacitor(US)2 = Электролитический конденсатор (США)2
Electrolytic Capacitor(EU)2 = Электролитический конденсатор (ЕС)2
Inductor(US) = Дроссель(США)
Inductor(EU) = Дроссель(ЕС)
Potentiometer_US = Потенциометр_US
Potentiometer_EU/IEC = Потенциометр_EU/IEC
Potentiometer_3D = Потенциометр_3D
Resistor(US) = Резистор (США)
Resistor(EU) = Резистор (ЕС)
Resistor 45 Deg(US) = Резистор, повёрнутый на 45 градусов(США)
Resistor 45 Deg(EU) = Резистор, повёрнутый на 45 градусов(ЕС)
Variable Capacitor(US) = Переменный конденсатор(США)
Variable Capacitor(EU) = Переменный конденсатор(ЕС)
Variable Resistor(US) = Переменный резистор(США)
Variable Resistor(EU) = Переменный резистор(ЕС)
Variable Inductor(US) = Переменный дроссель(США)
Variable Inductor(EU) = Переменный дроссель(ЕС)
Varistor = Варистор
Inductor2(US) = Дроссель2(США)
Inductor2(EU) = Дроссель2(ЕС)
Battery = Батарея
Voltage Source = Источник напряжения
Current Source = Источник тока
CCCS(Current Controlled Current Source) = CCCS(Источник тока управляемый током)
CCCS2(Current Controlled Current Source) = CCCS2(Источник тока управляемый током)
VCCS(Voltage Controlled Current Source) = VCCS(Источник тока управляемый напряжением)
VCVS(Voltage Controlled Voltage Source) = VCVS(Источник напряжения управляемый напряжением)
CCVS(Current Controlled Voltage Source) = CCVS(Источник напряжения управляемый током)
CCVS2(Current Controlled Voltage Source) = CCVS2(Источник напряжения управляемый током)

BV(Behavioral Voltage Sources) = BV(Поведенческие источники напряжения)
BI(Behavioral Voltage Sources) = BI(Поведенческие источники тока)
Epoly(Non-linear Voltage Source) = Epoly(Нелинейный источник напряжения)
Gpoly(Non-linear Current Source) = Gpoly(Нелинейный источник тока)

Diode = Диод
LED = Светодиод
LED_3D = Светодиод(3D)
Schottky Diode = Диод Шоттки
Varactor Diode = Варактор
Zener = Стабилитрон
Unidirectional TVS Diode = Однонаправленный супрессор
Bidirectional TVS Diode = Двунаправленный супрессор
Diac = Динистор
Bridge = Мост
78XX = 78XX
79XX = 79XX
LM317 = LM317
LM337 = LM337
TL431 = TL431
BJT(NPN) = BJT(NPN)
BJT(PNP) = BJT(PNP)
MOSFET(Nch) = MOSFET(N-канальный)
MOSFET(Nch) Depletion Four-pins = MOSFET(N-канальный) Depletion 4-х контактный
MOSFET(Nch) Enhancement = MOSFET(N-канальный) улучшенный
MOSFET(Nch) Enhancement Four-pins = MOSFET(N-канальный) улучшенный 4-х контактный
MOSFET(Pch) = MOSFET(P-канальный)
MOSFET(Pch) Depletion Four-pins = MOSFET(P-канальный) 4-х контактный
MOSFET(Pch) Enhancement = MOSFET(P-канальный) улучшенный
MOSFET(Pch) Enhancement Four-pins = MOSFET(P-канальный) улучшенный 4-х контактный
JFET(Nch) = JFET(N-канальный)
JFET(Pch) = JFET(P-канальный)
Darlington NPN = Сборка Дарлингтона(NPN)
Darlington PNP = Сборка Дарлингтона(PNP)
MESFET(Nch) = MESFET(N-канальный)
MESFET(Pch) = MESFET(P-канальный)

IGBT = IGBT
SCR = Тиристор
Triac = Симистор
Transform(US) = Трансформатор (США)
Transform(EU) = Трансформатор (ЕС)
Transfrom(NEUTRAL-CTR TAP)(US) = Transfrom(NEUTRAL-CTR TAP)(US)
Transfrom(NEUTRAL-CTR TAP)(EU) = Transfrom(NEUTRAL-CTR TAP)(EU)
Mutual Inductors = Взаимные катушки индуктивности
Mutual Inductors2 = Взаимные катушки индуктивности2
Or Gate = ИЛИ
Xor Gate = Исключающее ИЛИ
And Gate = И
Nor Gate = ИЛИ НЕ
Nand Gate = И НЕ
Not Gate = НЕ
Xnor Gate = Исключающее ИЛИ с инверсией
Tube Diode = Ламповый диод
Tube Triode = Ламповый триод
Tube Tetrode = Ламповый тетрод
Tube Pentode = Ламповый пентод
Voltage Controlled Switch = Переключатель контролируемый напряжением
Current Controlled Switch = Переключатель контролируемый током
SPST ON = Тумблер ON
SPST OFF = Тумблер OFF
Fuse = Предохранитель
555 = 555
555(Style2) = 555(стиль 2)
Speaker = Динамик
XTAL = Кварцевый резонатор
5pin Operational Amplifier = 5 контактный операционный усилитель
3pin Operational amplifier = 3 контактный операционный усилитель
Transmission Line = Линии передачи
Voltmeter = Вольтметр
Ammeter = Амперметр
LAMP = Лампа
Opto Transistor = Опто-транзистор

#Server Message
Need login = Нужно войти
Bad password = Неправильный пароль
We can't find your username or your email, please check it! = Мы не можем найти ваше имя пользователя или адрес электронной почты, проверьте данные!
Make sure your uploaded file size is less than 3MB! = Убедитесь, что размер загружаемого файла не превышает 3 Мб!
Bad file type = Неправильный формат файла
Empty file or bad file type, ensure your file is Eagle 6.0+ = Пустой файл или плохой тип файла, убедитесь, что ваш файл создан в Eagle 6.0+
This operation not supported on demo account = Эта операция не поддерживается в демо-режиме
Can not share this file under a private project, please set the active project to public! = Невозможно поделиться этим файлом в частном проекте, сделайте активный проект общедоступным!
Login Failed Too many attempts. If you forgot your password, please {0}reset your password{1} or send an email to support@easyeda.com = Слишком много попыток входа. Если вы забыли свой пароль, пожалуйста, {0}сбросьте ваш пароль{1} или отправьте письмо на support@easyeda.com

#Dialog Common Buttons
Common Buttons Setting = Общие настройки клавиш
Menu Setting... = Настройка меню...
Show/Hide = Показать/Скрыть
Move Up = Выше
Move Down = Ниже
Reset All = Сбросить всё
Zoom = Масштаб
Place Pin = Разместить контакт

#System Setting Dialog
System = Система
Zoom Mode = Режим масштабирования
Scroll Key = Клавиша скрола
CTRL + Scroll = CTRL + Scroll
Canvas Coordinate System = Система координат холста
SVG Coordinate = SVG-координаты
Cartesian Coordinate = Декартовы координаты
Open Wizard Dialog for New Schematic = Открыть диалог Мастера для новой схемы
Default Unit = Единицы по-умолчанию
Canvas Zoom Effect = Эфеект масштабирования холста
Quality Priority = Приоритет качества
Speed Priority = Приоритет скорости
Rotation Step = Шаг вращения
Add Teardrop Automatically = Добавлять разрыв автоматически
Assign Net for Free Track/Arc/Circle = Назначить Цепь для свободного линии/дуги/окружности
Open Wizard Dialog for New PCB = Открыть диалог мастера новой печатной платы
Rebuild Plane Automatically = Автоматически перестроить плоскость
The Track's Routing Follows Component's Rotation = Трассировки дорожек следуют за вращением компонента
Display Pad's Number and Net = Отображине номера контакта и Цепь
Favorite Track width = Запомнить ширину дорожки
Track Width Setting = Настройка ширины дорожки

#Dialog Access Control
Permissions = Разрешения
Operations = Операции
Access Control = Контроль доступа
Project Access Control = Контроль доступа проекта
Reject = Отклонить
Add User = Добавить пользователя
Bad email address = Неверный адрес эл. почты

# error info from backend
Can't find this email address in EasyEDA. Your partner must be an EasyEDA user. = Не удается найти этот адрес электронной почты в EasyEDA. Ваш партнер должен быть пользователем EasyEDA.

#Dialog waveForm
Grid Background = Фон сетки
Pane Background = Фон панелей
WaveForm Config = Настройка формы волны
Export Waveform = Экспорт формы сигнала в файл CSV


#attr-canvas-grid-style
dot = точка
line = линия

#attr-canvas-frame-size
Other = Другое
A4 Portrait = A4 Книжный
A4 Landscape = A4 Альбомный
A3 Portrait = A3 Книжный
A3 Landscape = A3 Альбомный
A2 Portrait = A2 Книжный
A2 Landscape = A2 Альбомный
A1 Portrait = A1 Книжный
A1 Landscape = A1 Альбомный
Landscape = Книжный
Portrait = Альбомный

#Stroke Style
solid = сплошная
dashed = пунктирная
dotted = точечная

#Solid Region
Solid Region = Сплошная область
Type = Тип
type = тип

#Dialog Libs Management
Report error = Отчёт об ошибке
Please give us some information to help us find the problem. = Пожалуйста, предоставьте нам некоторую информацию, которая поможет нам найти проблему.
Cannot place parts into this document: Schematic Symbols can only be placed into a Schematic; PCB Footprints can only be placed into a PCB. = Не удалось разместить компоненты в этом документе: элементы схем нужно размещать на схеме, шелкографию элементов на печатной плате.
Save it as a favorite part = Сохранить как любимый компонент
Only logged-in users can save this component as a Favorite Part but guest (Anonymous) users can place this component into their design directly. Would you like to place this component now? = Только вошедшие пользователи могут сохранить этот компонент в любимые, а гости (анонимы) могут разместить этот компонент столько сразу в документ. Вы хотите разместить этот компонент в документе?

#Others
Find libs = Найти библиотеки
My Projects = Мои проекты
My Parts = Мои компоненты
My Modules = Мои модули
Assembly LCSC Components = Assembly LCSC Components
Modules = Модули
SCH Module = Модуль Системного контроллера-концентратора
PCB Module = Модуль корпусов
System IC = System IC
LCSC (Official) = LCSC (Оффициальный)
LCSC Electronics = LCSC Electronics
Simple Mode = Простой режим
Expand Mode = Расширенный режим
Help Verify = Помогите проверить
Favorite Parts = Любимые компоненты
Shared With Me = Поделились со мной
Preview = Предпросмотр
Preview Window = Окно предпросмотра
System Default = По-умолчанию
User Defined = Определено пользователем
Theme = Тема
Theme Setting = Настройки темы
Close = Закрыть
Open = Открыть
Toggle toolbar = Показать/скрыть панель инструментов
Toggle left bar = Показать/скрыть левую панель
Toggle right bar = Показать/скрыть правую панель
Reload = Перезагрузить
Mouse-X = Позиция мыши по X
Mouse-Y = Позиция мыши по Y
Mouse-DX = Позиция DX
Mouse-DY = Позиция DY
Bus entry x1 = Ввод шины x1
Bus entry x2 = Ввод шины x2
Bus entry y1 = Ввод шины y1
Bus entry y2 = Ввод шины y2
Yes = Да
No = Нет
OK = ОК
Confirm = Подтвердить
Continue = Продолжить
Cancel = Отмена
Update = Обновить
Bus entry = Ветка шины
Filter = Фильтр
Check = Проверить
Share my work = Поделиться своей работой
Share it by e-mail, IM, blog, etc. = Поделиться через e-маил, мессенджер, блог, и т.д.

Copy the contents of this box into a text editor, then save the file. Paste the edited text back into this box and click Apply to update the display. = Скопируйте содержимое этого поля в текстовый редактор, затем сохраните файл. Вставьте отредактированный текст обратно в это поле и нажмите "Применить", чтобы обновить отображение.
Copy the contents of this box into a text editor, then save the file with a .svg extension. You can edit it in Inkscape or open it in your browser. = Скопируйте содержимое этого поля в текстовый редактор, затем сохраните файл с расширением svg. Вы сможете редактировать его в Inkscape или открыть в вашем браузере.
Content is too big to show, you can download it directly. = Контент слишком велик для показа, вы можете загрузить его напрямую.
SVG format = SVG-формат
SVG File = SVG-файл
Description should be no more than 250 letters = Описание должно быть не более 250 символов
The file save operation has timed out. Try again and check your Internet connection. = Превышено время ожидания выполнения запроса сохранения файла. Попробуйте ещё раз и проверьте своё подключение к Интернету.
Export Netlist = Экспортировать Netlist
Notifications = Уведомления
Please select txt or json files. = Пожалуйста, выберите txt или json файл.
Please select EasyEDA files. = Пожалуйста, выберите файлы EasyEDA.
Failed to read file [{file}] = Не удалось прочитать файл [{file}]
[{file}] is not a valid json file = [{file}] не является допустимым файлом json
Invalid parameters! = Некорректные параметры!
Download = Скачать
Start = Начать
You have unsaved files, are you sure you want to log out without saving the files? = У вас есть несохраненные файлы. Вы уверены, что хотите выйти без сохранения файлов?
Please use the web version to run this function. = Пожалуйста, используйте веб-версию, чтобы использовать эту функцию.
Please save this file to you project! = Пожалуйста, сохраните этот файл в ваш проект!
Nothing changed = Нет изменений
Delete Node = Удалить узел
This layer is invisible. = Этот слой невидимый.
When the solid region is Board Cutout, please set the layer to Multi-Layer. = Когда сплошная область это граница печатной платы, то установите слой в многослойный.
You should not try to assign a net to a Board Cutout solid region. = Вы не должны пытаться назначать цепь границе печатной платы в виде сплошной области.
Net Length = Длина Цепи
You can place a Pin in the schematic, but don't forget to group all of the Pins to a schematic component. Please click the help button to find out how to group them. If you just want to mark the wire, please use NetPort or NetLabel. = Вы можете поместить вывод в схему, но не забудьте сгруппировать все выводы в компонент схемы. Нажмите кнопку справки, чтобы узнать, как их сгруппировать. Если вы просто хотите пометить провод, используйте порт Цепи или метку Цепи.
Please input the modification = Пожалуйста, введите изменение
The content must be between {0} and {1} characters = Содержимое должно быть между {0} и {1} символов.

Coming soon = Скоро
No tool = Без инструмента
Help us translate into your language = Помогите нам перевести на ваш язык
Pad = Контакт
Via/Hole = Переходы/Отверстия
PCB Layers = Слои платы
Order PCB = Заказать плату
Share = Общий
Free = Свободно
Small = Маленький
Medium = Средний
Big = Большой


Embed = Встроить
HTML = HTML
URL = URL
BBCode = BBCode
PNG = PNG
Exporting as = Экспортировать как
Exporting as image = Экспортировать как изображение
Exporting as {0}SVG{1} file. = Экспрортировать как {0}SVG{1} файл.
Exporting as pdf is recommended: pdf gives good quality printed output and a small file size. = Рекомендуется экспортировать как pdf: pdf даёт хорошее качество при печати и имеет небольшой размер файла.
Generate PCB Fabrication File(Gerber) = Генирировать Gerber-файл для производства
PenWidth-Increase = Увеличение ширины пера

#Generate Gerber
Generate Gerber = Генерировать Gerber
Gerber View = Просмотр Gerber-файла
Dimensions(Estimated) = Размеры (оценка)
PCB Qty = Количество плат
Copper Weight = Толщина меди
PCB Price = Цена печатной платы
Estimated Delivery Time = Расчетное время доставки

HASL(with lead) = HASL(со свинцом)
LeadFree HASL-RoHS = HASL-RoHS(без свинца)
ENIG-RoHS = ENIG-RoHS(иммерсионное золото)
Would you like to do Design Rule Checking (DRC) before generating the Gerber files? = Хотели бы вы выполнить проверку правил проектирования (DRC) перед созданием файлов Gerber?
Yes, Check DRC = Да, проверить DRC
No, Generate Gerber = Нет, генерировать Gerber-файл
This PCB has uncompleted connection(s), do you want to check the connection(s)? = На этой печатной плате есть незавершенные соединения. Вы хотите проверить соединения?
Yes, Check Connection(s) = Да, проверить соединение(я)
It will then redirect to the web site of a third-party JLCPCB with which we cooperate. Are you ready? = Затем он будет перенаправлен на веб-сайт стороннего JLCPCB, с которым мы сотрудничаем. Вы готовы?
Failed to submit your order, please contact us via support@easyeda.com for help. = Не удалось отправить заказ, свяжитесь с нами по адресу support@easyeda.com для получения помощи.
Failed to submit your order, please contact us via QQ 800821856. = Не удалось отправить заказ, свяжитесь с нами по номеру QQ 800821856.
Order data generated finish, please click OK button and continue. = Генерация данных заказа завершена, нажмите кнопку «ОК» и продолжите.
[generateGerber]
Layers = Слои
[/generateGerber]

[version]
Switch = Выбрать
[/version]


Export your file, then print it yourself. = Экспортируйте свой файл, затем распечатайте его самостоятельно.
Trace width is too small = Ширина дорожки слишком маленькая
Share = Поделиться

Images Property = Параметры изображений
Connect Pad to Pad = Соединить площадку с площадкой
Copper Area = Медная область
Dimension = Размер


Please check that you have used Wire and not Line to connect electrical elements. = Пожалуйста, убедитесь, что вы использовали провод, а не линию для соединения электрических элементов.
PCB Fabrication Prices & capabilities = Производству печатных плат, цены и возможности
Flip all texts on bottom layer = Разместить весь текст на нижнем слое
Create New Document = Создать новый документ
General Package = Системный корпус
General Packages = Системные корпуса
favorite Package = избранные корпуса
Board Cutout = Граница печатной платы
Surface Mount = Поверхностный монтаж
JLCPCB Part Class = класс компонентов JLCPCB
base = базовый
expand = расширенный
recommend = рекомендуемый
Basic Part = базовая часть
Extended Part = расширенная часть
Recommended Part = рекомендуемая часть
smtWeld = smt-пайка
thtWeld = выводная пайка
manualWeld = ручная пайка
furnaceWeld = пайка оплавлением
Multi-Layer = Многослойная
Markdown Syntax = Синтаксис разметки
Markdown supported = Поддерживаемые разметки
Read only = Только чтение
Read/Write = Чтение/запись
More Libraries... = Больше библиотек...
Decompress failed! = Ошибка при извлечении!
Load failed! = Ошибка загрузки!
Loading = Загрузка
No Result = Нет результатов

#Dialog Place Pin in schematic warning
Place Pin in schematic warning = Поместить контакт в схемное предупреждение
You can place a Pin in schematic, but don't forget to group all of the Pins to a schematic component, please click the help button to find out how to group them. If you just want to mark the wire, please use NetPort or NetLabel. = Вы можете поместить контакт в схему, но не забудьте сгруппировать все контакты в компонент схемы. Нажмите кнопку справки, чтобы узнать, как их сгруппировать. Если вы просто хотите пометить провод, используйте порт Цепи или метку Цепи.
I know. Do not show this again. = Я знаю, больше не показывать.

#Extensions Setting
Extensions Setting = Настройки расширений
Remove = Удалить
Disable = Отключить
Enable = Включить
(Disabled) = (Отключено)
(Enabled) = (Включено)
Load Extension = Загрузить расширение
Enable or disable will be applied after reload page = Включение или отключение вступит в силу после обновления страницы
Your browser cannot run this function. = Вашему браузеру не доступна эта функция.
Your browser mode does not support indexedDB. Some features may not work properly. Are you using Private Browsing Mode? = Ваш режим браузера не поддерживает indexedDB. Некоторые функции могут работать неправильно. Вы используете режим приватного просмотра?
Extension Files = Файлы расширения
Extension ID = ID расшинения
Select Files = Выберите файлы

#Scripts
Script = Скрипт
Scripts = Скрипты
Script Content = Содержимое скрипта
Load from js file = Загрузить из js-файла
UTF-8 encoded js file = js-файл в кодировке UTF-8
Description = Описание
description = описание
Not a *.js file = Это не файл *.js
Failed to read file = Не удалось прочитать файл
System scripts cannot be modified = Нельзя изменить системные скрипты
Create Subfolder = Создать подпапку
Create Script = Создать скрипт
Install Script = Установить скрипт
Install = Установить
Desktop Client = Клиент для настольных ПК
Are you sure you want to remove this script? = Вы уверены, что хотите удалить этот скрипт?
Folder Name = Имя папки
Rename = Переименовать
Please select a script = Пожалуйста, выберите скрипт
Failed to load script = Не удалось загрузить скрипт
Run Script = Запустить скрипт
Load Script = Загрузить скрипт
Title is required = Укажите название
Script content is required = Требуется вставить содержимое скрипта
System Scripts = Системные скрипты
User Scripts = Пользовательские скрипты
You can right click on the tree nodes. = Вы можете щёлкнуть правой кнопкой мыши на узлах дерева файлов.

#PCB photoView toolbar
Top Side = Верхняя сторона
Bottom Side = Нижняя сторона
With Silk Layer = С шелкографией
No Silk Layer = Без шелкографии
Photo View = Просмотр платы

#check update
Check Update = Проверить обновления
EasyEDA Editor {ver} is released. Would you like to switch to the new version now? = Вышла новая версия редактора EasyEDA {ver}. Хотите перейти на новую версию сейчас?
LCEDA Editor {ver} is released. Would you like to switch to the new version now? = Вышла новая версия редактора LCEDA {ver}. Хотите перейти на новую версию сейчас?
Switch to New Version = Перейти на новую версию
Next Time = В следующий раз

#download project dialog
Generating download link... = Генерируем ссылку скачивания...
Download project now = Скачать проект сейчас

#Import DXF
Import DXF = Импорт dxf
Apply Unit = Применить единицы
Convert circle to HOLE on BoardOutLine layer = Преобразование круга в ОТВЕРСТИЕ на слое Граница печатной платы
No shapes found = Фигур не найдено
Fail to load the file = Не удалось загрузить файл
Please select a DXF file. = Пожалуйста, выберите файл DXF.
This feature only works for PCB document. = Эта функция работает только для документов печатных плат.
Select a DXF file = Выберите файл DXF

#Export DXF
Export DXF = Экспорт DXF
Plated-Through-Hole Pads = закрыть маской сквозные отверстия
Non-Plated-Through-Hole Pads = не закрывать маской сквозные отверстия
Silkscreen = Шелкография
Surface Pad = Поверностный контакт

#Data Sync
Data Sync = Синхронизация данных
Data Conflicts = Конфликты данных
Project or Document = Проект или документ
Cloud-Side = В облаке
Local-Side = Локально
Decision = Решение
Modified = Изменено
Deleted = Удалено
As Cloud = Как облачный
As Local = Как локальный
Skip = Пропустить
Data sync completed = Синхронизация данных завершена

#Team
Team = Команда
Teams = Команды
Switching team = Сменить Команду
Switch team failed = Не удалось сменить Команду
Load team info fail! = Не удалось загрузить информацию о Команде!
Load team info fail! Please reload. = Не удалось загрузить информацию о Команде! Пожалуйста, перезагрузите.
My Teams = Мои Команды
Create Team = Создать Команду

#Dialog Footprint Manager
Footprint Manager = Менеджер посадочных мест
Open Footprint Manager = Открыть менеджер посадочных мест
Schematic Components = Компоненты схемы
Edit Pin Map Information = Редактировать информацию карты контактов
Package Categories = Категории корпусов
Components List = Список компонентов
Personal = Личные
Component PIN information = Информация о контактах компонента
Footprint PAD information = Информация о посадочном месте контакта
Footprint Categories = Категория посадочных мест
Pad Number = Номер площадки
Search Footprint = Найти посадочное место
Select Footprint = Выбрать посадочное место
Search 3D Model = Поиск 3D модели
Select 3D Model = Выберите 3D модель
Filter by keyword = Поиск по ключевым словам
System Libs = Системные библиотеки

#dialog global delete
Drawings = Графику
Netlabel and netFlag = Имя Цепи и УГО Цепи
Texts = Тексты
Wires = Провода
Board outlines = Границы платы
Footprints = Посадочные места
Footprint = Посадочное место
Tracks = Дорожки

#dialog board outline settings
Current Size = Текущий размер
Paramenters = Параметры
Start X: = Начало X:
Start Y: = Начало Y:
Round Rectangular = Округлые углы прямоугольника
radius = радиус
only number is allowed! = можно вводить только цифры!
please input valid value of width! = пожалуйста введите существующее значение ширины!
please input valid value of height! = пожалуйста введите существующее значение высоты!
please input valid value of radius! = пожалуйста введите существующее значение радиуса!

#cross probe
The object you selected was not found in other documents. = Выбранный вами объект не найден в других документах.
No valid object for cross probe selected. = Не выбран корректный объект для cross probe.
Can not probe. Refreshing the window may get it to work. = Нет тестирования. Обновление окна может заставить его работать.
You need to login for this function to work. = Для работы этой функции необходимо авторизоваться.

#About Dialog
An Easier EDA Experience = Освой просто EasyEDA!
Version = Версия
BuiltDate = Дата сборки

#Auto Router Dialog
Auto Router Config = Настройки автотрассировщика
General Options = Общие настройки
All Layers = Все слои
Configure = Настройка
Sorry, your web browser does not support this feature. Please run a modern browser. = Извините, ваш браузер не поддерживает эту функцию. Пожалуйста, используйте современный браузер.
Please make sure all objects with net are inside the board outline! = Пожалуйста, убедитесь, что все объекты с цепями находятся внутри контура платы!
Cannot start again before previous activity is stopped = Невозможно повторить, пока предыдущая операция не будет остановлена
Please select a net = Пожалуйста, выберите цепь
TrackWidth cannot be empty = Ширина дорожки не может быть пустой
Clearance cannot be empty = Зазор не может быть пустым
Router is time out. = Превышено время трассировки.
Server is busy, please try again later. = Сервер занят, пожалуйста, попробуйте позже.
Due to the limitation of {0}router server{1} resources, multiple routers executing concurrently are not supported, please try again later or do it manually :-) = Из-за ограничения ресурсов {0}сервера трассировки{1} одновременное выполнение нескольких трассировок не поддерживается. Повторите попытку позже или сделайте это вручную :-)
Track Width is invalid = Ширина дорожки некорректна
General Clearance is invalid = Отступ по-умолчанию некорректен
SMD Clearance is invalid = Некорректный зазор между SMD
Diameter is invalid = Диаметр некорректен
Drill Diameter is invalid = Диаметр сверловки некорректен
Track width cannot be less than Design Rule Checking (DRC) setting value. = Ширина дорожки не может быть меньше значения настройки проверки правил проектирования (DRC).
General Clearance cannot be less than Design Rule Checking (DRC) setting value. = Зазор по-умолчанию не может быть меньше значения настройки проверки правил проектирования (DRC).
SMD Clearance cannot be less than Design Rule Checking (DRC) setting value. = Зазор SMD не может быть меньше значения параметра проверки правил проектирования (DRC).
Hole size cannot be less than Design Rule Checking (DRC) setting value. = Размер отверстия не может быть меньше значения параметра проверки правил проектирования (DRC).
Design Rule's via diameter must be larger than via drill diameter = Диаметр переходного отверстия в правилах проектирования должен быть больше диаметра сверловки.
Clearance cannot be less than Design Rule Checking (DRC) setting value. = Зазор не может быть меньше значения параметра проверки правил проектирования (DRC).
Not a valid PCB, please check it again = Некорректная печатная плата, пожалуйста, проверьте ещё раз
Previous connection must be closed = Предыдущее соединение должно быть замкнуто
Network error. Please try again. = Ошибка сети. Попробуйте ещё раз.
Router error. = Ошибка трассировки.
Invalid PCB. = Некорректная печатная плата.
General Clearance = Отступы по-умолчанию
SMD Clearance = Отступ между SMD
#Ripup Nets
Skip Routed Nets = Пропустить оттрассированные Цепи
Remove Existing Tracks = Удалить существующие дорожки
Real-time Display = Отображение в реальном времени
Router Layers = Слои трассировки
Via = Переходное отверстие
Special = Специальный
Special Nets = Специальные Цепи
Skip Nets = Пропустить Цепи
Router Server = Сервер трассировки
Local = Локальный
Cloud = Облачный
Available = Доступно
Unavailable = Недоступно
Checking = Проверка
Install Local Auto Router = Установить автотрассировщик локально
Checking local auto router server... = Проверяем локальный сервер автотрассировщика...
Stop Router = Остановить трассировщик
Auto Router is running... = Автотрассировщик запущен...

#Left Sidebar
Commonly Library = Стандартная библиотека
Basic = Базовый
Extend = Расширенный
Design Manager = Менеджер проектирования
Library = Библиотека
Spice Library = Библиотекаа Spice
Shared = Общий
LCSC = LCSC
LCSC Parts = LCSC компоненты
Supply Flag = Поставка
US = США
EU/IEC = EC/IEC
US Style = Американский стиль
Resistor = Резистор
Capacitor = Конденсатор
Inductor = Индуктивность
Switch/Key = Переключатель/кнопка
EU/IEC Style = Европейский стиль
CN = Китай
Connector = Коннектор
Switch/Relay = Переключатель/Реле
JLCPCB = JLCPCB
Recycle Bin = Корзина

# Protractor
Font Height = Высота шрифта
Precision = Точность
Protractor = Транспортир

#attr-pcbtext-line-width
Only default font family supports to change font width. = Только семейство шрифтов по-умолчанию, поддерживает изменение ширины шрифта.
Font is missing! You can confirm the dialog and use default font instead or cancel the dialog then upload your font and do it again. = Шрифт отсутствует! Вы можете подтвердить диалог и использовать вместо него шрифт по-умолчанию или отменить диалог, затем загрузить свой шрифт и попробовать снова.

#Common
Owner = Владелец
License = Лицензия
Part Pins = Контакты компонентов
Part Properties = Свойства компонентов
Net Pins = Контакты Цепи
Net Ratlines = Цепи без трассировки
Add Parameter = Добавить параметр
Histories record = История
Create Team = Создать Команду
Can't find this footprint on the server, please re-associate it. = Не удается найти  посадочное место на сервере, повторно свяжите его.
The footprint name associated with the component and the footprint name on the server are inconsistent, please re-associate it. = Имя посадочного места, связанное с компонентом, и имя посадочного места на сервере несовместимы, повторно свяжите его.
The symbol pin number(s) of the component does not match the associated footprint pad number(s), please modify the symbol pin number(s) or re-associate the footprint = Номер(а) контакта символа компонента не соответствует номеру(ам) соответствующей контактной площадке посадочного места, измените номер контакта символа или заново свяжите посадочное место
No footprint, please associate the footprint first. = Нет посадочного места, сначала свяжите посадочное место.
Can't find the package = Не могу найти компонент
The path is for the project URL identify, it is unique (the identity of the project owned by the user cannot be the same) = Путь предназначен для идентификации URL-адреса проекта, он уникален (идентификатор проекта, принадлежащего пользователю, не может совпадать)
It's with a letter or a number and can contain only numbers, letters, line-through, underscores, and points. It cannot be modified after saving. = Он состоит из буквы или цифры и может содержать только цифры, буквы, зачеркивание, символы подчеркивания и точки. Его нельзя изменить после сохранения.
Updating document to new format, please wait......After finishing please save your document with Ctrl + S. = Обновление документа до нового формата, пожалуйста, подождите.... После завершения сохраните документ, нажав Ctrl + S.
Open at current project? = Открыть в текущем проекте?
Please select a history to recover. = Пожалуйста, выберите запись истории для восстановления.
Be careful! When you click the "Recover" button, this sheet will be overwritten! = Будь осторожен! При нажатии кнопки "Восстановить" этот лист будет перезаписан!
Recover = Восстановить
There is no PCB under this project, would you like to create one? = В этом проекте нет печатной платы, вы хотели бы создать ее?
Please make sure that the chose Altium Designer files are saved as ASCII files. = Пожалуйста, убедитесь, что файлы Altium Designer сохранены в кодировке ASCII.
Export to Altium function is currently in beta: = Функция экспорта в Altium в настоящее время находится в стадии бета-тестирования:
1. Please be sure to read the notice before exporting: = 1. Обязательно прочитайте уведомление перед экспортом:
Export Altium notice and disclaimer = Уведомление об экспорте Altium и отказ от ответственности
2. Please be sure to check again after export! = 2. Обязательно проверьте еще раз после экспорта!
I have read and agree = Я прочитал и согласен
Export to Altium = Экспорт в Altium
Please make sure that the chose Eagle files are saved in Eagle v6.0 and above. = Пожалуйста, убедитесь, что файлы Eagle сохранены в формате Eagle v6.0 или выше.
Please make sure that the Kicad files were compressed as the .zip file. = Пожалуйста, убедитесь, что файлы Kicad были сжаты как файл .zip.
Open Altium Designer file = Открыть файл Altium Designer
The more information please refer at : = Дополнительную информацию смотрите здесь:
Please use Gerber file instead of exporting Altium if you are going to do PCB manufacturing. All PCB factories support the Gerber file. Is it ok to Generate the Gerber file? = Пожалуйста, используйте файл Gerber вместо экспорта Altium, если вы собираетесь производить печатные платы. Все заводы по производству печатных плат поддерживают файл Gerber. Сгенерировать файл Gerber?
Yes, Generate Gerber = Да, сгенерировать Gerber
No, Export Altium = Нет, экспортировать в Altium
Open Eagle file = Открыть файл Eagle
Open Kicad file = Открыть файл Kicad
Select file(s) = Выберите файл(ы)
Append to current project? = Добавить в текущий проект？
Append = Добавить
Open as new project = Открыть как новый проект
Tip: Press {0}SPACE{1} or {2}R{3} to rotate the placing object or selected object. = Совет: Нажмите {0}ПРОБЕЛ{1} или {2}R{3}, чтобы повернуть добавляемый или выбранный объект.
Hotkeys Setting = Настройки горячих клавиш
I know. Don't show this again. = Я знаю, больше не показывать.
Manufacturer Part Number can not be less than 2 characters. = Код производителя не может быть меньше 2 символов.
This prefix was changed to non-subpart format. = Этот префикс был изменен на формат без подчастей.
Save as New Project = Сохранить как новый проект
Save to Existing Project = Сохранить в существующий проект
Sheet Setting = Настройки листа
Sheet Size = Размер листа
Pre = Номер
pre = номер
Invalid Data = Некорректные данные
Others = Другие
You are not authorized to share this project. = У вас нет прав для совместного использования этого проекта.
This project is private: if you continue sharing it will be made public. = Этот проект является частным: если вы продолжите делиться им, он станет общедоступным.
Modify file info = Изменить информацию о файле
Please input search keyword = Пожалуйста, введите ключевое слово для поиска
Sort Projects by = Сортировать проекты по
Date Created = Дата создания
Date Modified = Дата изменения
Title = Название
Ascending = По-возрастанию
Descending = По-убыванию
Pin to Top = Закрепить наверху
Unpin from Top = Открепить сверху
Collapse / Expand = Свернуть / Развернуть
Expand = Развернуть
Expand All = Развернуть все
Collapse = Свернуть
Collapse All = Свернуть все
Your file hasn't been saved, do you want to save it? = Ваш файл не был сохранён, вы хотите сохранить его?
Don't Save = Не сохранять
Library Owner: = Владелец библиотеки:
verifyPkg.Value = Название
State = Состояние
Please select! = Пожалуйста, выберите!
Route = Трассировка
Import successfully: = Успешно импортировано:
Import failed: = Импорт не удался:
Path only contain 'a-z、A-Z、- 、 _ 、0-9'! = Путь может содержать только 'a-z、A-Z、- 、 _ 、0-9'!
Path must begin as 'a-z、A-Z、0-9'! = Путь должен начинаться как 'a-z、A-Z、0-9'!
The path length must be between 4~128 characters! = Длина пути должна быть от 4 до 128 символов!
The title length must be between 2 ~ 128 characters. = Длина названия должна быть от 2 до 128 символов!
Please select an owner = Пожалуйста, выберите владельца
Please select obj, wrl or zip file. = Пожалуйста, выберите файл obj, wrl или zip.
Do you want to delete this file? = Вы хотите удалить этот файл?
Add sub part success = Подчасть добавлена
Please input name and prefix! = Пожалуйста, введите имя и префикс!
Board outlines are not closed = Границы платы не замкнуты
Import failed! The imported files were not ASCII format, please save the files as "Advanced Schematic ascii(*.SchDoc)" or"PCB ASCII File(*.PcbDoc)" at Altium Designer first, and then import. = Не удалось импортировать! Импортированные файлы не были в формате ASCII. Сначала сохраните файлы как «Advanced Schematic ascii (*.SchDoc)» или «PCB ASCII File (*.PcbDoc)» в Altium Designer, а затем импортируйте.
The Pins "{0}" are not snapped on the grid point! This part maybe will cause some errors in the schematic. = Контакты "{0}" не привязаны к точкам сетки! Эта часть может вызвать некоторые ошибки в схеме.
Save failed! Pin number doesn't allow repeat! As below pin number repeat: {0} = Сохранить не удалось! Номер контакта не должен повторяться! Как показано ниже, повторяется номер контакта: {0}
Check Pin = Проверьте контакт
Failed to read {0} = Не удалось прочитать {0}
{0} is invalid = {0} некорректен
{0} not found = {0} не найден
Failed to execute script: = Не удалось выполнить скрипт:
One or more js files not found = Один или несколько файлов js не найдены
Only ONE {0} file is required = Требуется только один {0} файл
Extension ID is required = Требуется указать ID расширения
Extension ID is invalid = Неправильный ID расширения
Extension ID is duplicated = Повторяющийся ID расширения
No Result! = Нет результата！
Load Error = Ошибка загрузки
loading = загрузка
Failed to load spice data = Не удалось загрузить данные spice
Netlist = Список Цепей
Tags = Метки
Pin Information: = Информация о контакте:
Format incorrect, please check for the extra spaces or commas! = Неверный формат, проверьте наличие лишних пробелов и запятых!
Round Radius = Радиус скругления
Keyword: = Ключевое слово
Image = Изображение
Image copied. = Изображение скопировано.
Copy failed. = Ошибка копирования.
Copy success. = Скопировано.
Image Property = Свойство изображения
Locked = Заблокировано
Unlock All = Разблокировать все
Unlock = Разблокировать
Lock = Заблокировать
Please input pin name and pin number! = Пожалуйста, введите название контакта и номер контакта!
Left-Hand Panel = Левая панель
Right-Hand Panel = Правая панель
Update Components from Library = Обновить компоненты из библиотеки
The pin number(s) can't find the same pad number(s) = Не найден номер вывода(ов) с таким же номером контактной площадки
Designator = Обозначение
Replace = Заменить
Update failed = Не удалось обновить
Successfully updated = Обновлено
Update failed! = Не удалось обновить!
Successfully updated! = Обновлено!
Successfully updated {0} component(s)! = Успешно обновлены {0} компонент(ов)!
Change = Заменить
Check Footprints = Проверить посадочные места
Network Error! = Ошибка сети!
Find Similar Objects = Найти похожие объекты
Current Sheet = Текущий Лист
All Sheets = Все Листы
Kind = Тип
Range = Диапазон
Net Label/Net Flag/Net Port/Voltage Probe = Имя Цепи/флаг Цепи/Порт Цепи/Пробник напряжения
Bezier/Freehand Draw = Безье/Рисование от руки
Arc/Pie = Дуга/Круг
Objects Properties = Свойства объектов
Any = Любой
Same = Тот же
Different = Разный
Circular = Круглый
Expose Copper = Открытая медь
"{0}" font is missing. Please add the font to the font family list. = Отсутствует шрифт "{0}". Пожалуйста, добавьте шрифт в список семейств шрифтов.
Place Component = Разместить компонент
Delete Segment = Удалить сегмент
Angle = Угол
Board Thickness = Толщина платы
Layer Distance = Межслойное расстояние
Silk Screen = Шелкография
Surface Finish Color = Цвет финишного покрытия
Colors = Цвета
Board Color = Цвет печатной платы
Board Side = Сторона платы
Silk Screen = Шелкография
Silk Screen Color = Цвет Шелкографии
Display = Показать

# Array and Clone
Distribute Array = Распределить массив
Array Type = Тип массива
Matrix Array = Матричный массив
Circular Array = Куговой массив
Item Rotation = Вращение предмета
Location = Расположение
Items per Column = Количество элементов в колонке
Items per Row = Количество элементов в строке
# Column Spacing
# Row Spacing
Spacing(Degrees) = Интервал(градусы)
Start Degree = Начальный градус
Rotate Item to Match = Повернуть элемент до совпадения
Clockwise = По часовой стрелке
Anti-Clockwise = Против часовой стрелки
Distribute by = Распределить по
Column = Колонка
Row = Строка
Array Clone = Клонировать массив
Number of Rows = Количество строк
Number of Columns = Количество колонок
Number of Copies = Количество экземпляров
Distribute Range(Degrees) = Диапазон распределения(градусы)

# Theme color dialog
BusEntry = Ввод Шины
Foreground = Передний план
Common Used = Часто используемый
Original Theme = Исходная Тема
Theme Setting = Настройки Темы
Change the theme colors of your design = Измените цвета темы вашего дизайна
White on Black = Белое на чёрном
Black on White = Чёрное на белом
Custom Theme = Своя Тема
Color Setting = Настройки цвета
Apply Setting = Применить настройки
Theme Setting... = Настройки Темы...
Bus Entry = Ввод шины
Foreground = Передний план
Symbol Graphics = Графический символ
Common Used = Часто используемые
Draw = Рисовать
Sheet = Лист
The original theme only works for placing the new symbols. = Исходная тема работает только для размещения новых символов.
Selection Highlight = Подсветка выбора
Net Label / Port = Метка Цепи/ Порт

My Theme = Моя Тема
My Theme Settings = Настройки моей Темы
Apply 'Custom Theme' On = Применить 'Свою' тему на
Creating New Schematic = Создание новой схемы
Opening Existed Schematic = Открытие существующей схемы
Please fill in all parameters! = Пожалуйста, заполните все параметры!
Convert to Board Cutout = Преобразовать в контур печатной платы
Prefix Position = Позиция префикса
Name Position = Позиция имени
Center = По центру
Top =  Сверху
Bottom = Снизу
Left = Слева
Right = Справа
Does not support multiple objects to convert to Board Cutout at the same time = Не поддерживает одновременное преобразование нескольких объектов в контуре печатной платы.
Does not support multiple objects to convert to pad at the same time = Не поддерживает одновременное преобразование нескольких объектов в площадку.
Convert to Board Cutout = Преобразовать в контур печатной платы
Convert to Pad = Преобразовать в площадку
Convert to Component Shape = Преобразовать в форму компонента
Combine to Continuous Track = Объединить в непрерывную дорожку
Convert to Solid Region = Преобразовать в сплошную область
Substrate = Подложка
3D View = 3D вид
2D View = 2D вид
Pin Color = Цвет контакта
Name Color = Имя цвета
Number Color = Номер цвета
Dot = Точка

[theme]
Sheet = Лист
[/theme]


#history dialog
[history-dlg]
Number = Номер
Editor = Редактор
[/history-dlg]
View File History = Посмотреть историю файла
Save Time = Время сохранения

Invalid Format = Неправильный формат

#Dialog Teardrop
Round Pad / Via = Круглая площадка / Переходное отверстие
Rectangle / Oval / Polygon Pad = Прямоугольник / Овал / Многоугольная площадка
Applying Teardrops = Применить каплевидность
Removing Teardrops = Удалить каплевидность
Waiting = Ожидание
Progressing... = Выполняется...

No schematic in the project! = Нет схемы в проекте!

Move Forward = Вперед
Move Backward = Назад

#Dialog Panelize
V-CUT = Скрайбирование (v-cut)
Stamp Hole = Блок отверстий
No Panelize = Не панелизировать
Border and Marking = Граница и разметка
Create Border = Создать границу
Border Height = Высота границы
Border Position = Положение границы
Create Positioning Holes = Создать позиционные отверстия
Create Fiducial Marks = Создание реперных меток
Top and Bottom = Верх и низ
Left and Right = Лево и право
Stamp Hole Group - Column = Группа блока отверстий - колонок
Stamp Hole Group - Row = Группа блока отверстий - рядов
The number of rows and columns cannot be set to 1 simultaneously = Количество рядов и колонок не может быть установлено равным 1 одновременно.

#edit path point
[editPathPoints-dlg]
Arc(R) = Дуга(R)
Type = Тип
Action = Действие
add before = добавить перед
add after = добавить после
delete = удалить
[/editPathPoints-dlg]

#edit polygon point
[editPolygonPoints-dlg]
Action = Действие
add before = добавить перед
add after = добавить после
delete = удалить
[/editPolygonPoints-dlg]
You have unconfirmed edit! = У вас неподтвержденное редактирование!
Invalid edit! = Ошибочная правка!

#Dialog PCB Information
PCB Information... = Информация о печатной плате...
Signal Layers = Сигнальные слои
None Signal Layers = Несигнальные слои
Pads = Площадки
Surface Pads = Поверхностные площадки
Plated Through-hole Pads = Сквозные металлизированные отверстия
None Plated Through-hole Pads = Сквозные неметаллизированные отверстия
Holes = Отверстия
Vias = Переходные отверстия
Length of Tracks = Длина дорожек
Copper Areas = Медные области

#Differential Pair Routing
Differential Pair Routing = Трассировка дифференциальных пар
Differential Pair Rule Setting = Настройка трассировки дифференциальных пар
Please input track width = Ввердите ширину дорожки
Please input clearance = Введите зазор
Routing Rules = Правила трассировки

#Route Length Tuning
Track Length Tuning... = Настройка длины дорожки...
Tracks with different net or non-track found in current targets. = В текущей позиции обнаружены дорожки из другой Цепи или без трассировки.
Please select the signal tracks to be tuning. = Выберите сигнальные дорожки для настройки.
The total length exceeds the Design Rule Checking (DRC) constraint, continue ? = Общая длина превышает ограничение правил трассировки (DRC), продолжить?
45° Angle = угол 45°
90° Angle = угол 90°
DRC Track Length : = Длина дорожки DRC:
Current Length : = Текущая длина:
Additional Length : = Дополнительная длина:
Target Length: = Целевая длина:
Current Length: = Текущая длина:
Adjust Type = Настроить тип
Double Side = С двух сторон
Single Side = С одной стороны

can not connect to the server = невозможно соединиться с сервером

#Dialog Copper Area Manager
Copper Area Manager... = Управление медными областями...
Copper Area Manager = Управление медными областями
Order = Порядок
Name = Имя
Layer = Слой
Color = Цвет
Net = Цепь
Move Up = Переместить выше
Move Down = Переместить ниже
Apply = Применить
Cancel = Отмена
Copper Area do not allow self-intersection! = Медные участки не допускают самопересечения!
No copper area! = Нет медного участка!
#Dialog report error
Datasheet = Спецификация
Verification = Проверка
Symbol = Символ
Pad Number = Номер площадки
Pad Size = Размер площадки
Remark = Примечание
Correct = Правильно
Incorrect = Не праильно
Submit = Применить
Tip = Наконечник
Please select one component = Пожалуйста выберите один компонент
Location X = Позиция X
Location Y = Позиция Y
Your current browser version may not support some features. Please use the latest version of Chrome or Firefox, or try the desktop client. = Ваша текущая версия браузера может не поддерживать некоторые функции. Пожалуйста, используйте последнюю версию Chrome или Firefox, или попробуйте версию для стационарных компьютеров.
EasyEDA Client = Клиент EasyEDA
LCEDA Client = Клиент LCEDA
Chrome = Chrome
FireFox = FireFox
New Version = Новая версия
Switch Version = Переключить версию
Members = Члены
Update Time = Обновить время
Editor = Редактор
Current Version = Текущая версия
Latest Version = Последняя версия
Please select a different version to switch; If you want to edit different version in the same time, please open them in different browsers. = Выберите другую версию для переключения; Если вы хотите редактировать разные версии одновременно, откройте их в разных браузерах.
3D Model = 3D Модель
Board Side = Сторона платы
Display = Показать
Copper = Медь
Create New Version = Создать новую версию
Create new version success! = Новая версия создана!
Version Management = Управление версиями
Switch success! = Переключено!
Please close current version's documents first! = Сначала закройте документы текущей версии!
Creator = Создатель
Create Time = Время создания
Fail to connect to server! Please check your internet connection status and try again! = Не удалось подключиться к серверу! Пожалуйста, проверьте состояние подключения к Интернету и повторите попытку!
Spice Number = Версия Spice
Create = Создать
3D Outline = 3D Контур
Cannot create the slot hole via the board outline, please use the following methods: = Невозможно создать отверстие слота через контур платы, используйте следующие методы:
Use the solid region and set its type as Board Cutout = Используйте сплошную область и установите ее тип как контур платы.
Select a Track/Arc, right-click to use the "Convert to Board Cutout" = Выберите дорожку/дугу, щелкните правой кнопкой мыши, чтобы использовать "Преобразовать в контур платы".
Select all the closed Tracks/Arcs, right-click to use the "Convert to Board Cutout" = Выберите все закрытые дорожки/дуги, щелкните правой кнопкой мыши, чтобы использовать "Преобразовать в контур платы".
The more information please refer at = Более подробную информацию смотрите на
Save "{0}" success! = Сохранение "{0}" выполнено!
Save "{0}" failed! = Ошибка сохранения "{0}" !
Invalid Size = Неправильный размер
Processing = Обработка
Invalid Size = Неправильный размер
NetFlag GND = Флаг Цепи GND
NetFlag VCC = Флаг Цепи VCC
NetFlag +5v = Флаг Цепи +5v
No Useful Data! = Нет полезных данных!
SVG Preview = Предпросмотр SVG
Prefix contains not supported charater(s) ! = Префикс содержит неподдерживаемые символы !
Name contains not supported charater(s) ! = Имя содержит неподдерживаемые символы!
Create Grid Path = Создать рисунок в виде сетки
Please Input Name = Пожалуйста введите имя
Building Copper Area = Создать медную область
Processing = Обработка
Opening File = Открытие файла
Update from Library = Обновить из библиотеки
Update Footprint = Обновить посадочное место
Update 3D Model = Обновить 3D модель
Find footprint(s) have been updated, do you want to update? = Найдены посадочные места имеющие обновление, хотите обновить?
3D File: = Файл 3D:
Model List = Список моделей
Are you sure merge net {0} and net {1}? = Вы уверены, что хотите объединить Цепь {0} и Цепь {1}?
Display Footprint = Показать посадочное место
Display Footprint Name While Placing Component = Показывать имя посадочного места при размещении компонента
Annotate Prefix Automatically After Placing Component = Автоматически аннотировать префикс после размещения компонента
Program Error, Please Contact Technical Support! = Программная ошибка, обратитесь в службу технической поддержки!
Search Engine = Поиск в
Keyword to Filter = Ключевое слово для фильтрации
Normal Mode = Нормальный режим
Expand Mode = Расширенный режим
3D Model Manager = Управление 3D моделью
3D Model Preview = Предпросмотр 3D модели
3D Model = 3D Модель
3DModel =  3D Модель
Document = Документ

[pcblayer]
3DModel = 3D Model
Document = Документ
[/pcblayer]

Adjustment = Выравнивание
View Larger Image = Посмотреть увеличенное изображение
Previous = Предыдущий
Previous Image = Предыдущее изображение
Next Image = Следующее изображение
Notice: For reference only, please refer to the real product = Обратите внимание: только для справки, пожалуйста, обратитесь к реальному продукту
It's under designing, please wait. = Он находится в разработке, пожалуйста, подождите.
The width of track/arc/circle cannot be less than 0.1mil! = Ширина дорожки/дуги/окружности не может быть меньше 0.1 mil!
Clone success ! = Клонирование завершено!
Footprint Naming Reference = Справочник именования посадочных мест
3D Model Manager = Управление 3D моделью
Will jump to the Lichuang open source hardware platform (OSHWHub.com) to improve the information and share. Whether to continue? = Переход к аппаратной платформе с открытым исходным кодом Lichuang (OSHWHub.com), чтобы улучшить информацию и поделиться ею. Продолжить?
Will jump to the EasyEDA open source hardware platform (OSHWLab.com) to improve the information and share. Whether to continue? = Переход на аппаратную платформу с открытым исходным кодом EasyEDA (OSHWLab.com), чтобы улучшить информацию и поделиться ею. Продолжить?
The project content page will open. After adding a description and setting the project to public, you can click the share button to get the share link. = Открыта страница содержимого проекта. После добавления описания и установки общего доступа для проекта, вы можете нажать кнопку «Поделиться», чтобы получить ссылку на общий доступ.
This project is not public, can not view homepage! = Этот проект не является публичным, нельзя посмотреть домашнюю страницу!

[grid]
None = Нет
[/grid]

#lib verify and mounted
This component is verified = Этот компонент верефицирован
This component is unmounted = Этот компонент не установлен

#find component
Find Next = Найти следующий
Pin not found = Контакт не найден
Pad not found = Площадка не найдена
Object not found = Объект не найден

#offset Elements
Offset X = Смещение по X
Offset Y = Смещение по Y
Offset = Смещение
Absolute Offset = Абсолютное смещение
Relative Offset = Относительное смещение
Absolute Offset... = Абсолютное смещение...
Relative Offset... = Относительное смещение...
Reference Point X = Контрольная точка X
Reference Point Y = Контрольная точка Y

# Inner Plane layer
Rebuild Plane = Перестроить слой Plane
PlaneZone Properties = Свойства слой Plane-зоны
Change to a plane layer is not allowed during track routing. = Переход к plane-слою во время трассировки не допускается.
#pcblib rect
Fill = Залить
Fill Type = Тип заливки
[PlaneZone]
Solid = Сплошной
[/PlaneZone]

Solid Region do not allow self-intersection! = Сплошной регион не допускает самопересечения!

The prefix or name or text too far away from the footprint, if you don't want it to show up please make it hidden. = Префикс, имя или текст слишком далеко от посадочного места. Если вы не хотите, чтобы они отображались, скройте их.
The prefixes are not allowed to repeat! = Префиксы не могут повторяться!
Save failed! The origin of the canvas is not in the graphics! Whether to set the origin automatically? = Сохранить не удалось! Привязки полотна нет на графике! Установить привязку автоматически?
The origin of the canvas has been set in the graphics now, you can save again. = Привязка холста теперь установлена на графике, вы можете еще раз сохранить.
Backup Project = Резервирование проекта
Open Project Directory = Открыть каталог проекта

{0} items updated = {0} элементов обновлено

The current file {0} has an updated version. Do you want to overwrite it? If you want to open the latest version, please close the current file and reopen it. = Текущий файл {0} имеет обновленную версию. Вы хотите перезаписать его? Если вы хотите открыть последнюю версию, закройте текущий файл и снова откройте его.
Yes, Overwrite It = Да, перезаписать
No, Keep It = Нет, сохранить

Download Client = Скачать Клиент

Search tutorial、open source projects etc. = Руководство по поиску, проекты с открытым исходным кодом и т. д.

Go to LCSC and search for = Перейти на LCSC и найти
Go to LCSC = Перейти на LCSC

Hide Ratline Layer and Keep the Component Prefix When Paste Objects = Скрыть линии связи и сохранить префикс компонента при вставке объектов

ALL.layer = Все слои
Copper.layer = Медный слой
Non-Copper.layer = Слои без меди
Other.layer = Другие слои

Please enter at least 2 characters! = Пожалуйста, введите минимум 2 символа!
View Datasheet = Посмотреть спецификацию
View Datasheet... = Посмотреть спецификацию...

The corresponding package or network could not be found in the currently open PCB document = Соответствующий пакет или сеть не найдены в открытом в данный момент документе печатной платы.
delete fail = ошибка удаления

[crashRecovery]
Libraries = Библиотеки
[/crashRecovery]
Canvas origin anomaly! = Аномалия привязки холста!

Component's Name = Имя компонента
Component's Prefix = Префикс компонента
Component's Footprint = Посадочное место компонента

[findlib]
Clear = Очистить
Apply Filters = Применить фильтр
Result = Результат
Place = Установить
Prev = Предыдущий
Next = Следующий
Total {count} Count = Всего найдено {count}
About = О приложении
Items = Позиций
[/findlib]

Object = Обект
Layers and Objects = Слои и объекты
All = Все

Add custom = Добавить свое

Connections = Соединения
Attempted: = Попыток:
Completed: = Завершено:
Failed: = Неудачно:
Total Vias: = Всего переходов:

Please confirm moving option = Пожалуйста, подтвердите вариант переноса
Only this pad = Только эта площадка
For this component = Для этого компонента
View Owner = Показать владельца
View Detail = Показать подробности


# place batch vias
Place Vias = Установить переходные отверстия
Placing Vias = Установленные переходные отверстия
Removing Vias = Удаленные переходные отверстия
Batch Vias for Copper = Пакет переходных отверстий для медного слоя
Add/Remove Vias = Добавить/Удалить переходное отверстие
Diameter = Диаметр
Drill Diameter = Диаметр сверловки
Column Spacing = Интервал колонок
Row Spacing = Интервал строк
Multiple vias have been placed, do you want to rebuild the copper area? = Было размещено несколько переходных отверстий. Вы хотите перестроить медную область?
Remove vias finish, do you want to rebuild the copper area? = Удаление переходных отверстий закончено, вы хотите перестроить медную область?
The width of track/arc/circle cannot be less than 0.051mm/2mil/0.002inch! = Ширина дорожки/дуги/окружности не может быть меньше 0,051 мм/2 mil/0,002 дюйма!
Save fail! Please try again! = Ошибка сохранения! Пожалуйста, попробуйте еще раз!
Please select a copper outline = Пожалуйста, выберите медный контур
Can't find copper area at other layers, please add the copper area with the same net at other layer first. = Не удается найти медную область на других слоях, сначала добавьте медную область с той же Цепью на другом слое.

Add favorite success! = Успешное добавление в избранное!
Remove favorite success! = Успешное удаление из избранного!
Remove favorite failed! = Ошибка удаление из избранного!
Whether if remove favorite? = Убрать из избранного?
Split by ';' for multi tags = Разделяйте несколько тегов символом ';'

This size is the determined size! = Этот размер является определяемым размером!
The associated pad has been locked = Связанная площадка заблокирована
Split by space or , for multi tags = Разделить несколько тегов по ' ' или ','

Rotation X = Вращение по X
Rotation Y = Вращение по Y
Rotation Z = Вращение по Z

Some fields are filled invalid data = Некоторые поля заполнены неверными данными
start time should be earlier than stop time = время начала должно быть раньше времени окончания
Number of points should be less than 100 in octave variation = Количество точек должно быть меньше 100 в октавной вариации
Start frequency should be less than stop frequency. The suffix meg stands for Mega,m stands for milli = Начальная частота должна быть меньше конечной частоты. Суффикс meg означает Мега, m означает милли.
Get historical records fail! = Ошибка получения записей истории!
This 3D model didn't create the outlines successfully, please import it again or contact with us. = Для этой 3D-модели не удалось успешно создать контуры, пожалуйста, импортируйте ее снова или свяжитесь с нами.
There is No Tag! = Нет тега!
Assign successful! = Назначено!
Found footprint's pad number doesn't match the schematic component's pin number, please correct the pad number and try again! = Номер контактной площадки найденного посадочного места не соответствует номеру контакта компонента схемы, исправьте номер контактной площадки и повторите попытку!
Update Property = Обновить свойство
Update Properties = Обновить свойства
Please fill in at least 5 words. = Пожалуйста, введите не менее 5 слов.
Mouse hovering over the track to highlight the entire network = Наведите указатель мыши на дорожку, чтобы выделить всю Цепь
Net Highlighting While Cursor Hover the Track = Подсветка Цепи при наведении курсора на дорожку
When circle set as "Yes", the Pin length must be more than 6 = Когда круг установлен как «Да», длина контакта должна быть больше 6
Hi, I found a problem of your library, this library seems incorrect.\ntitle:{title}\nType:{type}\nlink:{link}\n{content}\nThank you! = Привет, я обнаружил проблему с вашей библиотекой, эта библиотека кажется неправильной. \nНазвание:{title}\nТип:{type}\nСсылка:{link}\n{content}\nСпасибо!

Logout fail! Please try again! = Ошибка выхода! Пожалуйста, попробуйте еще раз!
Logout success! We look forward you to use LCEDA again! = Вы вышли! Мы надеемся, что вы снова воспользуетесь LCEDA!
Logout success! We look forward you to use EasyEDA again! = Вы вышли! Мы надеемся, что вы снова воспользуетесь EasyEDA!
Click to Preview 3D = Нажмите, чтобы просмотреть 3D
[logoutDialog]
Logout = Выйти
[/logoutDialog]

[findlibTag]
All = Все
[/findlibTag]

Export Pick and Place File = Экспорт выбранного и размещение файла
Mirror the bottom component's X coordinate (JLCPCB doesn't need) = Зеркалировать координату X, нижнего компонента (для JLCPCB не требуется)
Work Space = Рабочая область
Include panelized components' coordinates = Включить координаты панелизации компонентов
Personal Workspace = Личная рабочая область
Work Space - {name} = Рабочая область - {name}
Work Space - Personal = Рабочая область - Личная
Cloning = Клонирование

Project Owner = Владелец проекта
Clone Project = Клонировать проект
Homepage = Домашняя страница
Apply for Education Edition = Подать заявку на версию для учебных заведений
Load Organization failed = Не удалось загрузить организацию
Joined = Присоединился
Favorite = Избранное
This operation will unfavorite this project, do you want to continue? = Эта операция удалит этот проект из избранного. Продолжить?
View Homepage = Посмотреть домашнюю страницу
Private Project = Частный проект
3-7 days = 3-7 дней
Close Tab = Закрыть вкладку
Close Other Tabs = Закрыть другие вкладки
Close All Tabs = Закрыть все вкладки
Open in New Window = Открыть в новом окне
Cursor Snap to Component's Origin or Pad Center While Dragging Component = Привязка курсора к исходной точке компонента или центру контактной площадки при перемещении компонента
Undefined = Не определено
Input = Вход
Model Unit = Модельный блок
File Unit = Файловый блок
This part contains subparts, please make sure you have checked other subparts before reporting error, do you want to continue? = Эта часть содержит подразделы, убедитесь, что вы проверили другие подразделы, прежде чем сообщать об ошибке. Хотите продолжить?

[saveAs]
Power = Питание
[/saveAs]

Assign LCSC Part# = Назначить номер детали LCSC
Unexpected error while converting. Perhaps unsupported file type or program bug. = Непредвиденная ошибка при конвертации. Возможно, неподдерживаемый тип файла или ошибка программы.
Found duplicated component IDs, please click "OK" to re-assign component ID automatically, and then save the document and try again. = Обнаружены повторяющиеся идентификаторы компонентов. Нажмите "ОК", чтобы автоматически переназначить идентификатор компонента, а затем, сохраните документ и повторите попытку.

#electromagneticSimulation
Electromagnetic Simulation... = Электромагнитное моделирование...
You will upload Gerber to SuperEM for electromagnetic simulation (only upload Gerber, not including account data), do you want to continue? = Вы загружаете Gerber в SuperEM для электромагнитного моделирования (загрузите только Gerber, не включая данные учетной записи). Вы хотите продолжить?
SuperEM is a 3-D full-wave electromagnetic simulation and design platform for high-speed PCB circuits and antennas, which is developed by Faraday Dynamics, Ltd. = SuperEM — это трехмерная полноволновая платформа для моделирования и проектирования высокоскоростных печатных плат и антенн, разработанная Faraday Dynamics, Ltd.
Visit the SuperEM = Посетить SuperEM
SuperEM User Guide = Руководство пользователя SuperEM
Upload Gerber to SuperEM successfully, please click "OK" buttun to continue = Загрузка Gerber в SuprEM прошла успешно, нажмите кнопку "ОК", чтобы продолжить

Format = Форматирование
View = Вид
Design = Дизайн
Simulation = Симуляция
Advanced = Дополнительно
Fabrication = Производство
Check DRC = Проверка DRC
Simulation Setting = Настройки симуляции
BOM = Материалы(BOM)
PCB Fabrication File(Gerber) = Файл для производства(Gerber)
Pick and Place File = Выбрать и разместить файл
Parts Order = Заказ компонентов
PCB Order = Заказ печатной платы
One-click Order Parts = Заказать компоненты в один клик
One-click Order PCB/SMT = Заказать PCB/SMT в один кдик
SIM = SIM
STD = STD
WaveForm = Волновая форма

Place Module = Разместить модуль
Please enter identification letters: = Пожалуйста, введите идентификационные буквы:
Only support English letters, up to 5. = Поддерживаются только английские буквы, не более 5.

Exist doesn't annotate prefix component(s) in the module, please edit and annotate the unique prefix(s) for component(s) first. = Exist не аннотирует компонент(ы) префикса в модуле, сначала отредактируйте и аннотируйте уникальный префикс(ы) для компонента(ов).
Opening = Открытие

Also update track's net (Only applies to circumstance under which prefix/netlabel changes and no component/wire is added or removed) = Также обновите Цепь дорожки (применяется только к обстоятельствам, при которых изменяется префикс/метка Цепи, а компонент/провод не добавляется и не удаляется)

# desktop client error feedback
Cannot open online documents on Project Offline mode. = Не удается открыть онлайн-документы в автономном режиме.

Please select a project = Пожалуйста, выберите проект
Opened Projects = Открытые проекты
Open Project = Открыть проект
Close Project = Закрыть проект
Open All Projects = Открыть все проекты
Close All Projects = Закрыть все проекты
Select Owner = Выбрать владельца
Select Folder = Выбрать папку
Select Owner or Folder = Выбрать владельца или папку
Select Project = Выбрать проект
Folder = Папка
New Folder = Новая папка
New Sub Folder = Новый подкаталог
Delete Folder = Удалить папку
Move Project = Переместить проект
Move Folder = Переместить папку
# Rename Folder =
Please input the folder name = Введите имя папки
Invalid folder name = Неправильное имя папки
Are you sure to delete this folder? = Вы уверены, что хотите удалить эту папку?
All projects in this folder will be moved to the root directory. = Все проекты в этой папке будут перемещены в корневой каталог.
Create new folder successfully = Успешное создание новой папки
Failed to create new folder = Ошибка создания новой папки
Delete folder successfully = Папка успешно удалена
Failed to delete folder = Ошибка удаления папки
Rename folder successfully = Папка успешно переименована
Failed to rename folder = Ошибка переименования папки
Move folder successfully = Папка успешно перемещена
Failed to move folder = Ошибка перемещения папки
Move project successfully = Проект успешно перемещен
Failed to move project = Ошибка перемещения проекта
The folder depth must not exceed {0} levels = Глубина вложенности папок не должна превышать {0}
Failed to add project to folder = Ошибка добавления проекта в папку

Doesn't support JLCPCB SMT Service = Не поддерживает службу JLCPCB SMT
{0} for JLCPCB SMT Service = {0} для службы JLCPCB SMT

Reset failed! There are duplicate component prefixes in the current schematic: = Сброс не выполнен! В текущей схеме есть повторяющиеся префиксы компонентов:
Reset failed! There are duplicate component prefixes in the current PCB: = Сброс не выполнен! В текущей плате есть повторяющиеся префиксы компонентов:
Please modify the component prefixes first to ensure that the component prefix is unique. = Сначала измените префиксы компонентов, чтобы убедиться, что префикс компонента уникален.

LCEDA(Standard) - A Simple and Powerful Electronic Circuit Design Tool = LCEDA (стандарт) — простой и мощный инструмент для проектирования электронных схем
EasyEDA(Standard) - A Simple and Powerful Electronic Circuit Design Tool = EasyEDA (стандарт) — простой и мощный инструмент для проектирования электронных схем

#Dialog for Package Custom Data
Please input the data title = Пожалуйста, введите заголовок данных
Data title duplicated = Заголовок данных дублируется
Cannot be more than {0} characters! = Не более {0} символов!
Only latin alphabets, digits, underscore(_) and hyphen(-) are allowed. = Допускаются только латинские буквы, цифры, знак подчеркивания (_) и дефис (-).
Invalid value of item {0} = Недопустимое значение элемента {0}
Update DFM = Обновить DFM
Custom DFM Data = Пользовательские данные DFM
Saved custom data successfully! = Пользовательские данные успешно сохранены!
Save custom data failed! = Не удалось сохранить пользовательские данные!
Will replace the graphics and custom data of current document, after imported please adjust the 3D model. Continue or not? = Это действие заменит графики и пользовательские данные текущего документа, после импорта настройте 3D-модель. Продолжить или нет?
Open footprint "Custom Data" dialog = Открыть диалоговое окно посадочных мест "Пользовательские данные"

# Create lead shape
Create Lead Shape = Создать форму вывода
Base on Pad Center = Базовая точка по центру площадки
Base on Canvas Origin = Базовая точка на точке привязке холста
Lead shape = Вывод
Footprint Type = Тип посадочного места
From pad shape = Из формы контактной площадки
Lead length = Длина вывода
Lead width = Ширина вывода
Lead diameter = Диаметр вывода
Scaling ratio = Коэффициент масштабирования
Leads creating direction = Направление создания выводов
Auto = Авто
Horizontal = Горизонтально
Vertical = Вертикально
Canvas origin to lead edge = От начала холста до кромки вывода
Canvas origin to body edge = От начала холста до кромки тела
Lead soldering length = длина покрытия вывода припоем
Lead soldering part diameter = Диаметр части вывода покрытой припоем
Component shape object doesn't overlap lead shape object, please check carefully. = Объект формы компонента не перекрывает объект формы выводов, внимательно проверьте.
The solder mask expansion of pads ({0},{1}) has a small clearance(less than 0.08mm), it will cause the soldering too short, please modify. = Расширение паяльной маски контактных площадок ({0},{1}) имеет небольшой зазор (менее 0,08 мм), это приведет к слишком короткокому месту пайки, пожалуйста, отредактируйте.
The paste mask expansion or custom paste mask layer objects of pads ({0},{1}) has a small clearance(less than 0.15mm), it will cause the stencil to create fail, please modify. = Расширение маски вставки или пользовательские объекты слоя маски вставки контактных площадок ({0},{1}) имеют небольшой зазор (менее 0,15 мм), это приведет к сбою создания трафарета, пожалуйста, отредактируйте.
System footprint must have pad number 1 or A1, please modify the pad number. = Системное посадочное место должно иметь контактную площадку номер 1 или A1, пожалуйста, измените номер контактной площадки.
System footprint doesn't allow two or more pad numbers are 1 or A1, please modify the pad number. = Системное посадочное место не позволяет использовать два или более номеров контактных площадок 1 или A1, измените номер контактной площадки.
Document layer has circle object, but jlcPara's polarity is 0, please check the Custom Data. = Слой документа имеет круговой объект, но полярность jlcPara's равна 0, проверьте пользовательские данные.
There are exist repeat pad numbers: {padNumber}, please check, if it is correct please ignore this. = Существуют повторяющиеся номера пэдов: {padNumber}, пожалуйста, проверьте, если это правильно, пожалуйста, игнорируйте это.
Can't find the circle at the component marking layer, or this circle doesn't at the same quadrant with the 1st pad, please check whether it is correct. = Не удается найти круг на слое маркировки компонента, или этот круг не находится в одном квадранте с 1-й контактной площадкой, проверьте правильность.

ROUND = КРУГЛЫЙ
RECTANGLE = ПРЯМОУГОЛЬНЫЙ
OCTAGONAL = ВОСЬМИУГОЛЬНЫЙ
Upper left = Верхний левый
Lower left = Нижний левый
Center of Pads = Центр площадки
First Pin = Первый контакт
Package Name = Имя компонента
Pins Number = Номер контакта
Rows Of Pin = Рядов контактов
Columns Of Pin = Колонок контактов
Polarity = Полярность
Pad Shape = Форма площадки
Body Diameter = Диаметр компонента
Lead Span = Межвыводное расстояние
Lead Vertical Span = Межвыводное расстояние по вертикали
Body Length = Длина компонента
Body Height = Высота компонента
Pin Diameter = Диаметр контакта
Pin Length = Длина контакта
Pin Height = Высота контакта
Pin Solid Width = Ширина сплошного контакта
Pin Solid Height = Высота сплошного контакта
Pin Spacing = Межконтактное расстояние
Pin Horizontal Spacing = Межконтактное расстояние по горизонтали
Pin Vertical Spacing = Межконтактное расстояние по вертикали
ThermalPad = Термоплощадка
Pad Expansion = Расширение площадки
Custom PasteMask = Пользовательская маска
Fabrication Tolerance = Производственный допуск
Placement Tolerance = Допуск размещения
FirstPin Position = Позиция первого контакта
Package Origin = Точка привязки компонента
Expansion Size = Расширенный размер
Corner = Угол платы
Angle = Угол (градусы)
Fillet = Кромка
Chamfer = Фаска
Update Preview = Обновить предпросмотр
Number of pins (left and right) = Количество контактов (слева и справа)
Number of pins (up and down) = Количество контактов (вверху и внизу)
Reference Use Cases = Примеры использования
Package Type = Тип упаковки
Capacitance = Конденсатор неполярный
Resistance = Сопротивление
Bidirectional Diode = Двунаправленный диод
Inductance = Индуктивность
Crystal Oscillator = Кварцевый генератор
Diode = Диод
LED = Светодиод
Fuse = Предохранитель
Entity height = Высота объекта
Lead Overhang = Выступ контакта
Lead Thickness = Толщина контакта
Unknown mistake = Неизвестная проблема
Has ThermalVias = Имеет тепловые переходы
Polar Capacitance = Конденсатор полярный

Create Component Marking = Создать маркировку компонентов
Create component marking successfully! = Маркировка компонента создана!
No elements on component shape layer! = На слое с формой компонента нет элементов!
No elements on lead shape layer! = На слое формы контактов нет элементов!
No pad of number 1 or A1, please modify the pad number. = Нет площадки номер 1 или A1, измените номер площадки.
Save failed! Component marking circle is at the axis. Do you want to recreate the component marking? = Сохранить не удалось! Окружность маркировки компонента находится на оси. Вы хотите пересоздать маркировку компонента?
If autoroute fail, you can export the autoroute file(DSN) to third-party autorouter tool(Such as: FreeRouting, Konekt Electra, Eremex TopoR etc.), and export the session file(SES) after finished autoroute, and then import to PCB. = Если автотрассировка не удалась, вы можете экспортировать файл автотрассировки (DSN) в сторонний инструмент автотрассировки (например, FreeRouting, Konekt Electra, Eremex TopoR и т. д.) и экспортировать файл сеанса (SES) после завершения автотрассировки, а затем импортировать в печатную плату.
Auto route failed! Found abnormal pad(s) data, please modify the pad width and height: = Автотрассировка не выполнена! Обнаружены ненормальные данные контактных площадок, измените ширину и высоту контактных площадок:
Select Properties = Выберите свойства
Combine the same parts' prefixes in one row = Объедините одинаковые префиксы частей в одну строку
Please check at least one item! = Пожалуйста, проверьте хотя бы один пункт!
Pins = Контакты
Check component latest version when open schematic = Проверить последнюю версию компонента при открытии схемы
Only show updated components = Показывать только обновленные компоненты
Note: When a PCB is Import Changes, the PCB is updated according to the footprint version to which the schematic is bound. = Примечание. Когда плата находится в состоянии "Импортировать изменения", плата обновляется в соответствии с версией посадочного места, к которой привязана схема.
Doesn't support to import the binary format DXF, please import the ASCII format DXF. = Не поддерживает импорт двоичного формата DXF, импортируйте формат ASCII DXF.

Find System Similar Footprint = Найти похожее системное посадочное место
Found similar footprints at system library, it is recommended to use them first. = Найдены похожие посадочные места в системной библиотеке, рекомендуется использовать их в первую очередь.
Copy Title = Копировать Наименование
Check system similar footprint = Проверьте системное аналогичное посадочное место
Can't find the Similar Footprint = Невозможно найти похожее посадочное место
Search failed! = Не найдено!
No package information! = Нет информации о корпусе
Find Parameters = Найти параметры
Find Results = Найти результаты

Bill of material(BOM) uploaded finish, please click "OK" to continue. = Список материалов (BOM) загружен, нажмите «ОК», чтобы продолжить.
Bill of material(BOM) upload failed! = Не удалось загрузить список материалов (BOM)!

All pads = Все площадки
All holes = Все отверстия
Single layer pads = Однослойные площадки
Multi-layer pads = Мультислойные площадки
Same X pads = Одинаковые Х площадки
Same Y pads = Одинаковые Y площадки
Same Y and clearance pads = Одинаковые Y и зазоры площадок
Same X and clearance pads = Одинаковые X и зазоры площадок
Same X and clearance pads' clearance = Одинаковые X и зазоры площадок - зазоры
Same Y and clearance pads' clearance = Одинаковые Y и зазоры площадок - зазоры
Pad's hole diameter(max) = Диаметр отверстия площадки(макс)
Pad's hole diameter(min) = Диаметр отверстия площадки(мин)
Pad's hole diameter(aver) = Диаметр отверстия площадки(средн)

Try Pro Edition = Попробуйте версию Про

Generate Solid Region by Objects Outline = Генерация сплошной области по контуру объектов
Generate Polygon Pad by Objects Outline =  Генерация площадки-полигона  по контуру объектов
Select the objects that cannot be generated = Выберите объекты, которые не должны генерироваться

Please compress schematic and PCB as a zip file and then import it, if you only import the schematic you need to binding with the footprint manually. = Заархивируйте схему и плату в виде zip-файла, а затем импортируйте его, если вы импортируете только схему, которую необходимо связать с посадочным местом вручную.
Please compress schematic and PCB in ASCII format as a zip file and then import it, if you only import the schematic you need to binding with the footprint manually. = Заархивируйте схему и плату в формате ASCII в виде zip-файла, а затем импортируйте его, если вы импортируете только схему, которую необходимо связать с посадочным местом вручную.
Import failed! The imported files were not ASCII format, please save the files as "Advanced Schematic ascii(*.SchDoc)" or"PCB ASCII File(*.PcbDoc)" at Altium Designer first, and then import. = Не удалось импортировать! Импортированные файлы не были в формате ASCII. Сначала сохраните файлы как «Advanced Schematic ascii (*.SchDoc)» или «PCB ASCII File (*.PcbDoc)» в Altium Designer, а затем импортируйте.
The PCB text will use the editor new font family, the text maybe will appear a little excursion. = Текст печатной платы будет использовать новое семейство шрифтов редактора, текст, возможно, покажется немного гуляющим.
Because of different file format and element, please check carefully after imported. = Из-за отличающегося формата файла и элемента, пожалуйста, внимательно проверьте после импорта.
Please make sure the EAGLE file is saved in EAGLE v6.0 and higher version. = Убедитесь, что файл EAGLE сохранен в версии EAGLE v6.0 и выше.
Please compress schematic and PCB as a zip file by KiCad5 and then import it, if you only import the schematic you need to binding with the footprint manually. = Сожмите схему и плату в виде zip-файла с помощью KiCad5, а затем импортируйте его, если вы импортируете только схему, которую необходимо связать с посадочным местом вручную.
Please make sure the Protel file is exported as ASCII format file. = Please make sure the Protel file is exported as ASCII format file.
Please compress the schematic and corresponding symbols as a zip file and then import it. = Сожмите схему и соответствующие символы в виде zip-файла, а затем импортируйте его.

Please save the files as "Advanced Schematic ascii(*.SchDoc)" or"PCB ASCII File(*.PcbDoc)" at Altium Designer first, and then import. = Сначала сохраните файлы как «Advanced Schematic ascii (*.SchDoc)» или «PCB ASCII File (*.PcbDoc)» в Altium Designer, а затем импортируйте.
Tips = Советы
Exists incomplete connection = Существует незавершенное соединение
Found that the board has incomplete connection, please check the nets and ratlines = Обнаружено, что плата имеет неполное соединение, проверьте цепи и линии связей
creator = создатель
You are not logged in or the login status is invalid, please login and try again. = Вы не вошли в систему или статус входа недействителен, пожалуйста, войдите и повторите попытку.
Display Board Cutout = Показать границы платы
